,FIPS,Lat,Long_,Confirmed,Deaths,Active,Combined_Key,Population
0,36061,40.76727260000001,-73.97152637,118302,8455,109847,"New York City, NY",8336817
1,36059,40.74066522,-73.58941873,26715,1057,25658,"Nassau, NY",1356924
2,26163,42.278056,-83.37861099999998,12544,884,11660,"Wayne, MI",1749343
3,36103,40.88320119,-72.8012172,23523,653,22870,"Suffolk, NY",1476601
4,36119,41.16278376,-73.75741653,20947,640,20307,"Westchester, NY",967506
5,17031,41.84144849,-87.81658794,17306,630,16676,"Cook, IL",5150233
6,34003,40.96010917,-74.07164325,10848,608,10240,"Bergen, NJ",932202
7,34013,40.78681335,-74.24657979,8579,590,7989,"Essex, NJ",798975
8,6037,34.30828379,-118.2282411,10517,405,10112,"Los Angeles, CA",10039107
9,26125,42.66090111,-83.38595416,5576,392,5184,"Oakland, MI",1257584
10,9001,41.26809896,-73.3881171,6480,365,6115,"Fairfield, CT",943332
11,26099,42.69158356,-82.92752801,3792,330,3462,"Macomb, MI",873972
12,34017,40.73766234,-74.07515667,8511,312,8199,"Hudson, NJ",672391
13,53033,47.49137892,-121.8346131,4620,303,4317,"King, WA",2252782
14,36087,41.15027894,-74.02560498,8474,298,8176,"Rockland, NY",325789
15,22071,30.06971951,-89.92660315,5769,287,5482,"Orleans, LA",390144
16,34039,40.65835409,-74.30680092,7438,269,7169,"Union, NJ",556341
17,34023,40.43629879,-74.41426991,6576,248,6328,"Middlesex, NJ",825062
18,22051,29.74075478,-90.11115756,5265,247,5018,"Jefferson, LA",432493
19,42101,40.00338507,-75.1379271,7441,222,7219,"Philadelphia, PA",1584064
20,25017,42.48607732,-71.39049229,6681,221,6460,"Middlesex, MA",1611699
21,9003,41.80283011,-72.73103891,2570,213,2357,"Hartford, CT",891720
22,34027,40.86095313,-74.54553709999998,3525,212,3313,"Morris, NJ",491845
23,9009,41.4080325,-72.93620426,3758,195,3563,"New Haven, CT",854757
24,34031,41.03238628,-74.29954144,6750,182,6568,"Passaic, NJ",501826
25,36071,41.40337468,-74.30240757,5830,178,5652,"Orange, NY",384940
26,34025,40.26549699,-74.22240686,4122,167,3955,"Monmouth, NJ",618795
27,34029,39.8895449,-74.28089251,4016,166,3850,"Ocean, NJ",607186
28,18097,39.78163624,-86.13826325,3204,155,3049,"Marion, IN",964582
29,25013,42.13440424,-72.63235561,1885,151,1734,"Hampden, MA",466372
30,25021,42.16073095,-71.20530408,3122,147,2975,"Norfolk, MA",706775
31,12086,25.6112362,-80.55170587,8066,146,7920,"Miami-Dade, FL",2716940
32,25025,42.3279514,-71.07850442,6279,145,6134,"Suffolk, MA",803907
33,25009,42.6687626,-70.94687179,3894,140,3754,"Essex, MA",789034
34,32003,36.21458855,-115.0130241,2559,115,2444,"Clark, NV",2266715
35,55079,43.00486062,-87.96733172,1870,105,1765,"Milwaukee, WI",945726
36,12099,26.64676272,-80.46536002,1814,105,1709,"Palm Beach, FL",1496770
37,34035,40.56465737,-74.61683016,2001,101,1900,"Somerset, NJ",328934
38,36029,42.76249024,-78.73063652,1812,101,1711,"Erie, NY",918702
39,12011,26.15184651,-80.48725556,3363,92,3271,"Broward, FL",1952778
40,26049,43.02244215,-83.70589709,1084,89,995,"Genesee, MI",405813
41,25023,41.94070556,-70.80802823,2308,89,2219,"Plymouth, MA",521202
42,13095,31.53328528,-84.21722377,1308,83,1225,"Dougherty, GA",87956
43,42091,40.21053671,-75.36652296,2475,82,2393,"Montgomery, PA",830915
44,17197,41.44619267,-87.97862712,1433,81,1352,"Will, IL",690743
45,53061,48.04615983,-121.7170703,1988,80,1908,"Snohomish, WA",822083
46,34021,40.28047017,-74.70479631,1856,76,1780,"Mercer, NJ",367430
47,25027,42.35026951,-71.90493363,2350,74,2276,"Worcester, MA",830622
48,11001,38.90417773,-77.01655992,2197,72,2125,"District of Columbia, DC",705749
49,24033,38.83070039,-76.8496441,2516,72,2444,"Prince George's, MD",909327
50,42071,40.03904563,-76.24770128,914,69,845,"Lancaster, PA",545724
51,17043,41.85116968,-88.08642662,1386,66,1320,"DuPage, IL",922921
52,6085,37.23104908,-121.6970462,1793,65,1728,"Santa Clara, CA",1927852
53,22033,30.53842039,-91.09777565,1325,62,1263,"East Baton Rouge, LA",440059
54,13121,33.79216944,-84.46319413,1844,62,1782,"Fulton, GA",1063937
55,17097,42.3224907,-88.00367925,1711,62,1649,"Lake, IL",696535
56,42045,39.91680171,-75.40243663,1935,60,1875,"Delaware, PA",566747
57,4013,33.34835867,-112.4918154,2146,60,2086,"Maricopa, AZ",4485414
58,22103,30.40942847,-89.95642711,924,60,864,"St. Tammany, LA",260419
59,48201,29.86,-95.39,4097,58,4039,"Harris, TX",4713325
60,22017,32.57991587,-93.88375652,1118,57,1061,"Caddo, LA",240204
61,25005,41.79228404,-71.10872211,1508,56,1452,"Bristol, MA",565217
62,8031,39.76018276,-104.8725695,1402,56,1346,"Denver, CO",727211
63,36055,43.14638895,-77.69322942,884,56,828,"Monroe, NY",741770
64,8123,40.55499405,-104.3929621,858,55,803,"Weld, CO",324492
65,24031,39.13676329,-77.20358245,1933,54,1879,"Montgomery, MD",1050688
66,6073,33.03484597,-116.7365326,1930,53,1877,"San Diego, CA",3338330
67,29189,38.63770039999999,-90.4458375,1851,53,1798,"St. Louis, MO",994205
68,51087,37.53460572,-77.39326555,453,52,401,"Henrico, VA",330818
69,42017,40.33682119,-75.10836643,1399,52,1347,"Bucks, PA",628270
70,6065,33.74314981,-115.9933578,1961,50,1911,"Riverside, CA",2470546
71,34007,39.80343818,-74.96388753,1587,49,1538,"Camden, NJ",506471
72,22095,30.12597499,-90.4753503,569,47,522,"St. John the Baptist, LA",42837
73,21111,38.18664655,-85.65931031,573,46,527,"Jefferson, KY",766757
74,27053,45.00761521,-93.47694895,651,46,605,"Hennepin, MN",1265843
75,34005,39.87681124,-74.66927768,1261,45,1216,"Burlington, NJ",445349
76,48113,32.76670599,-96.7779605,1986,43,1943,"Dallas, TX",2635516
77,8005,39.64977461,-104.3353617,1183,43,1140,"Arapahoe, CO",656590
78,13067,33.94243204,-84.5761255,924,43,881,"Cobb, GA",760141
79,24005,39.45784712,-76.62911955,1485,41,1444,"Baltimore, MD",827370
80,8041,38.83240149,-104.5251411,652,41,611,"El Paso, CO",720403
81,34037,41.13891592,-74.69118243,551,41,510,"Sussex, NJ",140488
82,39099,41.01631101,-80.77287029,486,41,445,"Mahoning, OH",228683
83,39035,41.424119,-81.65918339,1281,39,1242,"Cuyahoga, OH",1235072
84,6001,37.64629437,-121.8929271,964,36,928,"Alameda, CA",1671329
85,9005,41.7937534,-73.2451475,490,35,455,"Litchfield, CT",180333
86,48029,29.44928723,-98.52019748,815,33,782,"Bexar, TX",2003554
87,18089,41.41874274,-87.38277575,876,33,843,"Lake, IN",485493
88,6067,38.45106826,-121.3425374,853,32,821,"Sacramento, CA",1552058
89,24003,39.00670238,-76.60329337,845,32,813,"Anne Arundel, MD",579234
90,6071,34.84060306,-116.1774685,977,31,946,"San Bernardino, CA",2180085
91,8059,39.58635604,-105.2517692,809,31,778,"Jefferson, CO",582881
92,20209,39.11727348,-94.76378225,363,31,332,"Wyandotte, KS",165429
93,34041,40.85951833,-74.99556527,468,30,438,"Warren, NJ",105267
94,48439,32.77143818,-97.29101614,990,30,960,"Tarrant, TX",2102515
95,24510,39.30211911,-76.61151012,1060,29,1031,"Baltimore City, MD",593490
96,4019,32.0971334,-111.7890033,700,29,671,"Pima, AZ",1047279
97,24013,39.56453592,-77.02373735,262,29,233,"Carroll, MD",168447
98,53005,46.23946995,-119.5120834,266,29,237,"Benton, WA",204390
99,13135,33.96044201,-84.02137802,852,29,823,"Gwinnett, GA",936250
100,53077,46.45738486,-120.7380126,635,29,606,"Yakima, WA",250873
101,39095,41.62101218,-83.65468618,596,28,568,"Lucas, OH",428348
102,42089,41.05934058,-75.34031025,872,28,844,"Monroe, PA",170271
103,9007,41.45949668,-72.53714864,379,28,351,"Middlesex, CT",162436
104,42011,40.41570541,-75.92457766,1335,28,1307,"Berks, PA",421164
105,39061,39.19673558,-84.54502924,594,27,567,"Hamilton, OH",817473
106,8001,39.87432092,-104.3362578,726,27,699,"Adams, CO",517421
107,22005,30.20406249,-90.91328409999998,440,27,413,"Ascension, LA",126604
108,42079,41.17823008,-75.98447579,1567,27,1540,"Luzerne, PA",317417
109,18057,40.07306535,-86.05244729,510,27,483,"Hamilton, IN",338011
110,47165,36.46824103,-86.45917204,466,27,439,"Sumner, TN",191283
111,29510,38.63555736,-90.24349225,723,26,697,"St. Louis City, MO",300576
112,22089,29.90709658,-90.35555967,476,26,450,"St. Charles, LA",53100
113,47157,35.1864775,-89.89692423,1359,26,1333,"Shelby, TN",937166
114,42003,40.46809875,-79.98167747,904,26,878,"Allegheny, PA",1216045
115,42069,41.43564672,-75.60379201,527,26,501,"Lackawanna, PA",209674
116,48303,33.61008596,-101.8204789,330,25,305,"Lubbock, TX",310569
117,18081,39.48994426,-86.10149107,347,25,322,"Johnson, IN",158167
118,42077,40.6154815,-75.59435245,1922,25,1897,"Lehigh, PA",369318
119,53073,48.82227976,-121.7490018,269,25,244,"Whatcom, WA",229247
120,25011,42.58119713,-72.58602547,160,25,135,"Franklin, MA",70180
121,42029,39.97291773,-75.74768357,675,25,650,"Chester, PA",524989
122,42095,40.75182733,-75.30471829,1251,25,1226,"Northampton, PA",305285
123,17089,41.93842729,-88.42861412,463,24,439,"Kane, IL",532403
124,4005,35.83883429,-111.7707178,266,24,242,"Coconino, AZ",143476
125,26161,42.253105,-83.83853204,798,24,774,"Washtenaw, MI",367601
126,18095,40.16143691,-85.71964711,273,24,249,"Madison, IN",129569
127,53053,47.03892768,-122.1405958,1000,23,977,"Pierce, WA",904980
128,40109,35.55140095,-97.40716948,483,22,461,"Oklahoma, OK",797434
129,41051,45.54747959,-122.4169351,430,22,408,"Multnomah, OR",812855
130,12071,26.58410348,-81.88399313,677,22,655,"Lee, FL",770577
131,39133,41.16793482,-81.19735782,158,22,136,"Portage, OH",162466
132,6059,33.70147516,-117.76459979999998,1376,22,1354,"Orange, CA",3175692
133,9013,41.85853803,-72.3308481,216,22,194,"Tolland, CT",150721
134,25003,42.37428441,-73.20524838,370,21,349,"Berkshire, MA",124944
135,19113,42.07923082,-91.59809485,276,21,255,"Linn, IA",226706
136,6081,37.4228808,-122.32755459999998,747,21,726,"San Mateo, CA",766573
137,40143,36.11939621,-95.94013939,362,21,341,"Tulsa, OK",651552
138,51059,38.83677558,-77.27565836,1298,21,1277,"Fairfax, VA",1147532
139,39109,40.0543329,-84.22871271,125,21,104,"Miami, OH",106987
140,13205,31.22483255,-84.19381821,172,20,152,"Mitchell, GA",21863
141,36001,42.60060306,-73.97723916,548,20,528,"Albany, NY",305506
142,24021,39.47296601,-77.39999394,442,20,422,"Frederick, MD",259547
143,10003,39.57992638,-75.64054974,974,20,954,"New Castle, DE",558753
144,12081,27.47196942,-82.31831044,276,19,257,"Manatee, FL",403253
145,20091,38.88548175,-94.82250877,334,19,315,"Johnson, KS",602401
146,50007,44.46322849,-73.08359212,372,19,353,"Chittenden, VT",163774
147,39049,39.96995815,-83.01115755,1102,19,1083,"Franklin, OH",1316756
148,26145,43.33433923,-84.05131209999998,313,19,294,"Saginaw, MI",190539
149,22109,29.37343766,-90.82626855,273,18,255,"Terrebonne, LA",110461
150,36027,41.76486060000001,-73.74356679,2048,18,2030,"Dutchess, NY",294218
151,40027,35.20413532,-97.32519562,294,18,276,"Cleveland, OK",284014
152,47037,36.17007426,-86.78646056,1237,18,1219,"Davidson, TN",694144
153,12095,28.51367621,-81.31799498,1073,18,1055,"Orange, FL",1393452
154,12057,27.9276559,-82.32013172,869,18,851,"Hillsborough, FL",1471968
155,25001,41.72980578,-70.28854339,530,18,512,"Barnstable, MA",212990
156,39151,40.81482476,-81.36437305,176,17,159,"Stark, OH",370606
157,1073,33.55554728,-86.89506300000002,625,17,608,"Jefferson, AL",658573
158,53063,47.62113146,-117.4046494,278,17,261,"Spokane, WA",522798
159,1097,30.78472347,-88.20842409,548,17,531,"Mobile, AL",413210
160,6075,37.75215114,-122.4385672,1013,17,996,"San Francisco, CA",881549
161,13015,34.23732119,-84.83887523,235,17,218,"Bartow, GA",107738
162,6077,37.93433732,-121.2730061,341,17,324,"San Joaquin, CA",762148
163,35001,35.05163625,-106.6703554,477,17,460,"Bernalillo, NM",679121
164,22047,30.25734305,-91.3499598,256,17,239,"Iberville, LA",32511
165,37119,35.24469268,-80.8317671,1015,16,999,"Mecklenburg, NC",1110356
166,22055,30.2049055,-92.06959876,375,16,359,"Lafayette, LA",244390
167,12115,27.18546175,-82.33174248,252,16,236,"Sarasota, FL",433742
168,36101,42.2689144,-77.3829924,151,16,135,"Steuben, NY",95379
169,26081,43.03197711,-85.54934642,354,16,338,"Kent, MI",656955
170,22097,30.59724262,-92.00135806,116,16,100,"St. Landry, LA",82124
171,29183,38.77875681,-90.66662425,400,16,384,"St. Charles, MO",402022
172,10005,38.66143781,-75.39031349,678,16,662,"Sussex, DE",234225
173,22019,30.22931235,-93.35400434,282,15,267,"Calcasieu, LA",203436
174,48157,29.52704478,-95.77219463,627,15,612,"Fort Bend, TX",811688
175,22105,30.62888673,-90.40664996,418,15,403,"Tangipahoa, LA",134758
176,6107,36.22026558,-118.8020203,352,15,337,"Tulare, CA",466195
177,8013,40.09313619,-105.3546767,299,15,284,"Boulder, CO",326196
178,13089,33.76944049,-84.22396017,1191,15,1176,"DeKalb, GA",759297
179,18003,41.09194313,-85.06800636,180,15,165,"Allen, IN",379299
180,22057,29.52470226,-90.40976986,499,15,484,"Lafourche, LA",97614
181,13177,31.779330600000005,-84.14324253,264,15,249,"Lee, GA",29992
182,53011,45.77568046,-122.4829204,258,15,243,"Clark, WA",488241
183,39153,41.12464734,-81.53123079,294,15,279,"Summit, OH",541013
184,6013,37.91923498,-121.9289527,615,14,601,"Contra Costa, CA",1153526
185,48121,33.20521901,-97.11691153,521,14,507,"Denton, TX",887207
186,12031,30.33225875,-81.66976468,745,14,731,"Duval, FL",957755
187,34015,39.71581067,-75.13995546,602,14,588,"Gloucester, NJ",291636
188,34019,40.56335249,-74.91284156,356,14,342,"Hunterdon, NJ",124371
189,23005,43.8370751,-70.37226999,339,14,325,"Cumberland, ME",295003
190,48453,30.33432034,-97.7853562,900,14,886,"Travis, TX",1273954
191,42007,40.6825484,-80.34921611,158,14,144,"Beaver, PA",163929
192,12103,27.93130349,-82.72239666,513,14,499,"Pinellas, FL",974996
193,32031,40.66562265,-119.6631594,549,14,535,"Washoe, NV",471519
194,36111,41.89027881,-74.26252104,745,13,732,"Ulster, NY",177573
195,22093,30.02531716,-90.80212061,210,13,197,"St. James, LA",21096
196,48041,30.663644800000004,-96.30205577,149,13,136,"Brazos, TX",229211
197,55025,43.06601594,-89.41733797,351,13,338,"Dane, WI",546695
198,6111,34.44465746,-119.0910613,365,13,352,"Ventura, CA",846006
199,39155,41.31735028,-80.76109643,199,13,186,"Trumbull, OH",197974
200,13063,33.54187245,-84.35594188,456,13,443,"Clayton, GA",292256
201,18031,39.30712658,-85.50087166,155,13,142,"Decatur, IN",26559
202,34001,39.47538693,-74.65848483,322,13,309,"Atlantic, NJ",263670
203,36067,43.00491923,-76.19971155,563,12,551,"Onondaga, NY",460528
204,1081,32.60154883,-85.35132246,269,12,257,"Lee, AL",164542
205,28075,32.40419769,-88.66229662,165,12,153,"Lauderdale, MS",74125
206,24017,38.51092331,-76.98580666,310,12,298,"Charles, MD",163257
207,8035,39.33133796,-104.930001,311,12,299,"Douglas, CO",351154
208,18063,39.76719009,-86.51037283,360,12,348,"Hendricks, IN",170311
209,45079,34.01791263,-80.90267209,548,12,536,"Richland, SC",415759
210,13059,33.95436462,-83.37124007,98,12,86,"Clarke, GA",128331
211,13261,32.03650571,-84.19821492,273,12,261,"Sumter, GA",29524
212,12119,28.70181754,-82.0794267,114,11,103,"Sumter, FL",132420
213,17111,42.32451172,-88.45248227,264,11,253,"McHenry, IL",307774
214,22015,32.67932307,-93.60460152,211,11,200,"Bossier, LA",127039
215,47065,35.17670231,-85.16652245,110,11,99,"Hamilton, TN",367804
216,42129,40.31377979999999,-79.46615476,237,11,226,"Westmoreland, PA",348899
217,48167,29.40167322,-94.90469073,392,11,381,"Galveston, TX",342139
218,45045,34.89502264,-82.37295012,400,11,389,"Greenville, SC",523542
219,22075,29.42245447,-89.60322085,147,11,136,"Plaquemines, LA",23197
220,13273,31.77527543,-84.44069698,135,11,124,"Terrell, GA",8531
221,17163,38.46996033,-89.93063427,225,10,215,"St. Clair, IL",259686
222,48085,33.18820114,-96.57264368,477,10,467,"Collin, TX",1034730
223,55133,43.01833055,-88.30431188,238,10,228,"Waukesha, WI",404198
224,26087,43.09052506,-83.22153148,125,10,115,"Lapeer, MI",87607
225,41047,44.90287942,-122.5815117,294,10,284,"Marion, OR",347818
226,22087,29.87761636,-89.51887093,383,10,373,"St. Bernard, LA",47244
227,12105,27.95027105,-81.69732947,286,10,276,"Polk, FL",724777
228,36021,42.24819348,-73.63089095,100,10,90,"Columbia, NY",59461
229,22099,30.13112107,-91.61403569,174,10,164,"St. Martin, LA",53431
230,1017,32.91360079,-85.39072749,221,10,211,"Chambers, AL",33254
231,36105,41.71579493,-74.76394559,424,10,414,"Sullivan, NY",75432
232,37081,36.07959451,-79.78824948,151,10,141,"Guilford, NC",537174
233,34009,39.15008829,-74.80170244,178,10,168,"Cape May, NJ",92039
234,39103,41.11770589,-81.89986209999998,122,10,112,"Medina, OH",179746
235,35045,36.50838318,-108.320437,200,10,190,"San Juan, NM",123958
236,6041,38.07122463,-122.7210631,171,10,161,"Marin, CA",258826
237,17091,41.13746989,-87.86205334,226,10,216,"Kankakee, IL",109862
238,39037,40.13412966,-84.6194517,52,10,42,"Darke, OH",51113
239,22117,30.85288548,-90.03866652,173,10,163,"Washington, LA",46194
240,39169,40.82925852,-81.88844833,56,10,46,"Wayne, OH",115710
241,5119,34.77054088,-92.31355101,343,10,333,"Pulaski, AR",391911
242,39029,40.76932373,-80.78094576,123,10,113,"Columbiana, OH",101883
243,16001,43.4526575,-116.24155159999998,538,9,529,"Ada, ID",481587
244,26115,41.92734151,-83.53749864,211,9,202,"Monroe, MI",150500
245,12019,29.98319144,-81.85609986,170,9,161,"Clay, FL",219252
246,26157,43.46606813,-83.41897025,47,9,38,"Tuscola, MI",52245
247,18019,38.48015445,-85.70510334,137,9,128,"Clark, IN",118302
248,36063,43.19898042,-78.74777412,229,9,220,"Niagara, NY",209281
249,8069,40.66671597,-105.4625784,198,9,189,"Larimer, CO",356899
250,29095,39.01002188,-94.34724536,237,9,228,"Jackson, MO",703011
251,13275,30.86392347,-83.91847289,92,9,83,"Thomas, GA",44451
252,24027,39.25305293,-76.93126208,424,9,415,"Howard, MD",325690
253,13153,32.45802497,-83.66879087,142,9,133,"Houston, GA",157863
254,18093,38.84112637,-86.48361629,73,9,64,"Lawrence, IN",45370
255,55089,43.38352225,-87.94625009,77,9,68,"Ozaukee, WI",89221
256,22121,30.46058217,-91.30989571,78,9,69,"West Baton Rouge, LA",26465
257,26059,41.88753639,-84.59312019,81,9,72,"Hillsdale, MI",45605
258,16069,46.32638236,-116.7500975,20,9,11,"Nez Perce, ID",40408
259,26075,42.24807035,-84.42258681,195,8,187,"Jackson, MI",158510
260,45051,33.9212828,-78.99555293,150,8,142,"Horry, SC",354081
261,37101,35.51745004,-78.36622717,107,8,99,"Johnston, NC",209339
262,40113,36.62888819,-96.39635704,61,8,53,"Osage, OK",46963
263,21107,37.30939025,-87.54670406,91,8,83,"Hopkins, KY",44686
264,26077,42.24542231,-85.53038622,103,8,95,"Kalamazoo, MI",265066
265,12127,29.05858895,-81.18263252,242,8,234,"Volusia, FL",553284
266,13057,34.24393976,-84.47431861,225,8,217,"Cherokee, GA",258773
267,26147,42.92655373,-82.67937954,221,8,213,"St. Clair, MI",159128
268,12111,27.37763908,-80.47106649,172,8,164,"St. Lucie, FL",328297
269,45063,33.89665987,-81.27146426,218,8,210,"Lexington, SC",298750
270,48479,27.7610369,-99.33237355,223,8,215,"Webb, TX",276652
271,22073,32.47645559,-92.15704172,411,8,403,"Ouachita, LA",153279
272,22031,32.05457447,-93.74130302,134,8,126,"De Soto, LA",27463
273,13245,33.35777107,-82.07026432,168,8,160,"Richmond, GA",202518
274,36093,42.81668777,-74.05278291,237,8,229,"Schenectady, NY",155299
275,28109,30.77090935,-89.58677275,102,8,94,"Pearl River, MS",55535
276,12017,28.84804315,-82.47614748,74,8,66,"Citrus, FL",149657
277,36007,42.15903158,-75.81326086,153,8,145,"Broome, NY",190488
278,39113,39.75394919,-84.29050975,211,8,203,"Montgomery, OH",531687
279,29077,37.2575872,-93.34230916,80,8,72,"Greene, MO",293086
280,21117,38.93950319,-84.53241199,106,8,98,"Kenton, KY",166998
281,22003,30.65385745,-92.82442028,74,8,66,"Allen, LA",25627
282,53029,48.14713305,-122.5216407,163,8,155,"Island, WA",85141
283,16083,42.35440512,-114.6685381,79,7,72,"Twin Falls, ID",86878
284,39093,41.29553751,-82.15083537,203,7,196,"Lorain, OH",309833
285,1055,34.04567266,-86.04051873,78,7,71,"Etowah, AL",102268
286,19153,41.68679484,-93.57767461,224,7,217,"Polk, IA",490161
287,1123,32.86698258,-85.79833053,127,7,120,"Tallapoosa, AL",40367
288,18047,39.4142482,-85.06062647,75,7,68,"Franklin, IN",22758
289,51107,39.08990083,-77.63481877,367,7,360,"Loudoun, VA",413538
290,26093,42.60302282,-83.91297209,254,7,247,"Livingston, MI",191995
291,13243,31.76622818,-84.75732369,131,7,124,"Randolph, GA",6778
292,45013,32.39226291,-80.72619758,205,7,198,"Beaufort, SC",192122
293,9011,41.48896435,-72.10430976,236,7,229,"New London, CT",265206
294,22079,31.19778499,-92.52997303,179,7,172,"Rapides, LA",129648
295,22037,30.84425359,-91.04976723,81,7,74,"East Feliciana, LA",19135
296,37089,35.33788927,-82.4766782,99,7,92,"Henderson, NC",117417
297,41067,45.55972701,-123.0955257,364,7,357,"Washington, OR",601592
298,21067,38.0368225,-84.45576892,206,7,199,"Fayette, KY",323152
299,26021,41.95447397,-86.41313079999998,123,7,116,"Berrien, MI",153401
300,22045,29.86803617,-91.75871777,159,7,152,"Iberia, LA",69830
301,49035,40.66616532,-111.9216011,1285,7,1278,"Salt Lake, UT",1160437
302,10001,39.08646628,-75.56884914,345,7,338,"Kent, DE",180786
303,1117,33.26879845,-86.66232561,237,7,230,"Shelby, AL",217702
304,42103,41.33155042,-75.03208106,268,7,261,"Pike, PA",55809
305,27123,45.01625271,-93.09872295,164,7,157,"Ramsey, MN",550321
306,40145,35.96024096,-95.51911308,102,7,95,"Wagoner, OK",81289
307,45055,34.33988254,-80.58763164,187,7,180,"Kershaw, SC",66551
308,6019,36.75733899,-119.6466953,251,7,244,"Fresno, CA",999101
309,37159,35.64003916,-80.52446628,216,7,209,"Rowan, NC",142088
310,36079,41.42630093,-73.74965532,634,7,627,"Putnam, NY",98320
311,6061,39.06167234,-120.7240569,129,7,122,"Placer, CA",398329
312,22013,32.34569994,-93.05398492,42,7,35,"Bienville, LA",13241
313,45041,34.02361754,-79.70189312,87,7,80,"Florence, SC",138293
314,45027,33.66610974,-80.21647898,90,6,84,"Clarendon, SC",33745
315,36083,42.71348136,-73.51089874,140,6,134,"Rensselaer, NY",158714
316,15003,21.45803166,-157.97121819999995,369,6,363,"Honolulu, HI",974563
317,12055,27.34254618,-81.34071957,64,6,58,"Highlands, FL",106221
318,13247,33.65145002,-84.02202167,107,6,101,"Rockdale, GA",90896
319,55101,42.74753117,-88.05941254,138,6,132,"Racine, WI",196311
320,47149,35.84591405,-86.4107263,253,6,247,"Rutherford, TN",332285
321,18059,39.82304555,-85.77566351,129,6,123,"Hancock, IN",78168
322,13045,33.58138199,-85.07976677,237,6,231,"Carroll, GA",119992
323,25015,42.33997957,-72.65898478,239,6,233,"Hampshire, MA",160830
324,42025,40.91545395,-75.7068525,112,6,106,"Carbon, PA",64182
325,28083,33.55545125,-90.29900733,55,6,49,"Leflore, MS",28183
326,5069,34.26767081,-91.92619839,106,6,100,"Jefferson, AR",66824
327,41071,45.23330449,-123.3086963,32,6,26,"Yamhill, OR",107100
328,13115,34.26268279,-85.21577392,120,6,114,"Floyd, GA",98498
329,48245,29.8832777,-94.16434171,140,6,134,"Jefferson, TX",251565
330,48091,29.80811278,-98.27647225,43,6,37,"Comal, TX",156209
331,27169,43.98772283,-91.78081305,51,6,45,"Winona, MN",50484
332,13099,31.32155345,-84.90255207,141,6,135,"Early, GA",10190
333,8037,39.62754308,-106.6933637,468,6,462,"Eagle, CO",55127
334,28139,34.76872156,-88.90988194,45,6,39,"Tippah, MS",22015
335,12009,28.29409504,-80.73091022,173,6,167,"Brevard, FL",601942
336,39085,41.69710807,-81.23676539,124,6,118,"Lake, OH",230149
337,48347,31.62017125,-94.61803994,64,6,58,"Nacogdoches, TX",65204
338,27137,47.6048407,-92.46879855,43,6,37,"St. Louis, MN",199070
339,53057,48.48171488,-121.766131,198,6,192,"Skagit, WA",129205
340,48339,30.30079133,-95.50572772,331,6,325,"Montgomery, TX",607391
341,13097,33.70291126,-84.77026156,197,6,191,"Douglas, GA",146343
342,28047,30.51359752,-89.12467576,129,5,124,"Harrison, MS",208080
343,28045,30.41830223,-89.48851033,49,5,44,"Hancock, MS",47632
344,13113,33.41357794,-84.49089434,120,5,115,"Fayette, GA",114421
345,1101,32.2206831,-86.20969272,174,5,169,"Montgomery, AL",226486
346,45083,34.92960077,-81.99225984,191,5,186,"Spartanburg, SC",319785
347,17115,39.86064913,-88.96342505,44,5,39,"Macon, IL",104009
348,47187,35.89099229,-86.89281867,322,5,317,"Williamson, TN",238412
349,26045,42.59599185,-84.83740035,77,5,72,"Eaton, MI",110268
350,13293,32.87920671,-84.30024826,135,5,130,"Upson, GA",26320
351,26103,46.4338914,-87.64043701,27,5,22,"Marquette, MI",66699
352,45085,33.91826534,-80.37942316,161,5,156,"Sumter, SC",106721
353,42043,40.41377078,-76.77993242,271,5,266,"Dauphin, PA",278299
354,45007,34.51828081,-82.63959517,114,5,109,"Anderson, SC",202558
355,18141,41.61756781,-86.29040834,273,5,268,"St. Joseph, IN",271826
356,39173,41.36224827,-83.62285108,64,5,59,"Wood, OH",130817
357,12015,26.90131002,-81.92949121,124,5,119,"Charlotte, FL",188910
358,27037,44.67172617,-93.06299363,103,5,98,"Dakota, MN",429021
359,22063,30.44143993,-90.73061664,133,5,128,"Livingston, LA",140789
360,8085,38.40214114,-108.26390220000002,63,5,58,"Montrose, CO",42758
361,31055,41.29518299,-96.15085305,251,5,246,"Douglas, NE",571327
362,26121,43.29123859,-86.15176712,93,5,88,"Muskegon, MI",173566
363,13151,33.4533428,-84.14814659999998,321,5,316,"Henry, GA",234561
364,13051,32.00043026,-81.12489526,160,5,155,"Chatham, GA",289430
365,53007,47.87046092,-120.6173956,61,5,56,"Chelan, WA",77200
366,12097,28.06312234,-81.14882926,361,5,356,"Osceola, FL",375751
367,20177,39.04100763,-95.7557264,82,5,77,"Shawnee, KS",176875
368,28059,30.54020656,-88.64184064,182,5,177,"Jackson, MS",143617
369,16027,43.61970148,-116.7095499,167,5,162,"Canyon, ID",229849
370,42019,40.91152759,-79.91351055,150,5,145,"Butler, PA",187853
371,37023,35.74989637,-81.70755735,60,5,55,"Burke, NC",90485
372,26037,42.94400871,-84.60145248,100,5,95,"Clinton, MI",79595
373,16013,43.4085812,-113.9752658,458,5,453,"Blaine, ID",23021
374,12069,28.76202069,-81.7125123,179,5,174,"Lake, FL",367118
375,12021,26.11091986,-81.34687065,395,5,390,"Collier, FL",384902
376,26065,42.59716886,-84.37472069,270,5,265,"Ingham, MI",292406
377,22001,30.2950649,-92.41419698,105,5,100,"Acadia, LA",62045
378,13071,31.18810588,-83.7677946,89,5,84,"Colquitt, GA",45600
379,40147,36.71380786,-95.90514104,118,5,113,"Washington, OK",51527
380,18043,38.32117957,-85.90385377,116,5,111,"Floyd, IN",78522
381,42073,40.99206278,-80.33393706,55,5,50,"Lawrence, PA",85512
382,13223,33.91969522,-84.86848792,117,5,112,"Paulding, GA",168667
383,28011,33.79696941,-90.87372121,70,5,65,"Bolivar, MS",30628
384,13117,34.22604035,-84.12315129999998,153,5,148,"Forsyth, GA",244252
385,29071,38.41127108,-91.07522826,87,4,83,"Franklin, MO",103967
386,17167,39.75836914,-89.65872023,50,4,46,"Sangamon, IL",194672
387,6099,37.55862499,-120.9970722,163,4,159,"Stanislaus, CA",550660
388,13285,33.03349196,-85.02812115,68,4,64,"Troup, GA",69922
389,17161,41.46613806,-90.57042164,138,4,134,"Rock Island, IL",141879
390,18029,39.14647946,-84.97333539,61,4,57,"Dearborn, IN",49458
391,55105,42.67151616,-89.07147900000002,62,4,58,"Rock, WI",163354
392,40055,34.93535801,-99.5605612,50,4,46,"Greer, OK",5712
393,22111,32.83121059,-92.3749373,56,4,52,"Union, LA",22108
394,18035,40.22787247,-85.39732772,77,4,73,"Delaware, IN",114135
395,35043,35.68862401,-106.8687803,262,4,258,"Sandoval, NM",146748
396,12113,30.69341450000001,-87.02458128,115,4,111,"Santa Rosa, FL",184313
397,36091,43.10904162,-73.86653895,227,4,223,"Saratoga, NY",229863
398,5023,35.53864922,-92.02640019,70,4,66,"Cleburne, AR",24919
399,34033,39.58719656,-75.34696629999998,84,4,80,"Salem, NJ",62385
400,22101,29.69262097,-91.44702164,130,4,126,"St. Mary, LA",49348
401,55111,43.42574087,-89.94966132,31,4,27,"Sauk, WI",64442
402,12033,30.67652764,-87.37284571,260,4,256,"Escambia, FL",318316
403,39055,41.49952319,-81.17935342,82,4,78,"Geauga, OH",93649
404,31079,40.87257079,-98.50218293,214,4,210,"Hall, NE",61353
405,48141,31.76980765,-106.2363275,346,4,342,"El Paso, TX",839238
406,37067,36.12859861,-80.25459052,125,4,121,"Forsyth, NC",382295
407,22027,32.82308512,-92.99526883,44,4,40,"Claiborne, LA",15670
408,42041,40.1625372,-77.26130755,131,4,127,"Cumberland, PA",253370
409,13255,33.26310031,-84.28013991,90,4,86,"Spalding, GA",66703
410,17077,37.78595185,-89.38232563,39,4,35,"Jackson, IL",56750
411,29037,38.64789422,-94.353399,45,4,41,"Cass, MO",105780
412,22119,32.70847669,-93.33121835,69,4,65,"Webster, LA",38340
413,18067,40.48527731,-86.11351892,60,4,56,"Howard, IN",82544
414,13321,31.55162306,-83.85090513,104,4,100,"Worth, GA",20247
415,13215,32.50931999,-84.87142262,177,4,173,"Muscogee, GA",195769
416,18011,40.0509304,-86.46841646,129,4,125,"Boone, IN",67843
417,13299,31.05449097,-82.42224148,66,4,62,"Ware, GA",35734
418,22053,30.26896765,-92.81210004,48,4,44,"Jefferson Davis, LA",31368
419,55059,42.57639354,-88.04051686,204,4,200,"Kenosha, WI",169561
420,27091,43.67429718,-94.55099908,39,4,35,"Martin, MN",19683
421,17201,42.33641854,-89.16085327,112,4,108,"Winnebago, IL",282572
422,1111,33.29526734,-85.45708831,45,4,41,"Randolph, AL",22722
423,12085,27.0772071,-80.43109784,138,4,134,"Martin, FL",161000
424,28085,31.53288662,-90.45391915,81,4,77,"Lincoln, MS",34153
425,19183,41.33577126,-91.71725711,101,4,97,"Washington, IA",21965
426,26073,43.64060976,-84.84664923,43,4,39,"Isabella, MI",69872
427,8101,38.17359144,-104.5127437,64,4,60,"Pueblo, CO",168424
428,1093,34.13697363,-87.88704173,58,4,54,"Marion, AL",29709
429,40071,36.81799745,-97.14421435,45,4,41,"Kay, OK",43538
430,48491,30.64655664,-97.6004854,124,4,120,"Williamson, TX",590551
431,2020,61.14998174,-149.14269860000005,139,4,135,"Anchorage, AK",288000
432,41043,44.48899494,-122.5373154,53,4,49,"Linn, OR",129749
433,6113,38.68278902,-121.9018288,102,4,98,"Yolo, CA",220500
434,22077,30.71409502,-91.60209535,53,4,49,"Pointe Coupee, LA",21730
435,17133,38.27594376,-90.17761038,49,4,45,"Monroe, IL",34637
436,39167,39.45690571,-81.49121382,47,4,43,"Washington, OH",59911
437,42133,39.9210089,-76.73040131,381,4,377,"York, PA",449058
438,47093,35.99508821,-83.94635435,174,4,170,"Knox, TN",470313
439,28049,32.2656285,-90.44435448,280,4,276,"Hinds, MS",231840
440,23031,43.47808377,-70.71052375,156,4,152,"York, ME",207641
441,36065,43.24375382,-75.43710392,246,4,242,"Oneida, NY",228671
442,1077,34.90171875,-87.65624729,22,4,18,"Lauderdale, AL",92729
443,18091,41.54366008,-86.74072188,42,4,38,"LaPorte, IN",109888
444,18005,39.20744865,-85.89558181,113,4,109,"Bartholomew, IN",83779
445,39003,40.77285242,-84.10802343,51,4,47,"Allen, OH",102351
446,28081,34.291877500000005,-88.68149954,46,4,42,"Lee, MS",85436
447,17195,41.75509713,-89.91556058,29,3,26,"Whiteside, IL",55175
448,13313,34.80987459,-84.96093476,31,3,28,"Whitfield, GA",104628
449,36051,42.72596275,-77.77966158,34,3,31,"Livingston, NY",62914
450,18117,38.54118920000001,-86.49523093,19,3,16,"Orange, IN",19646
451,42051,39.92041012,-79.64291195,58,3,55,"Fayette, PA",129274
452,13077,33.35334302,-84.76129976,136,3,133,"Coweta, GA",148509
453,17179,40.50716185,-89.51404662,21,3,18,"Tazewell, IL",131803
454,45015,33.20222596,-79.94654523,101,3,98,"Berkeley, SC",227907
455,41003,44.49167306,-123.4316987,25,3,22,"Benton, OR",93053
456,18041,39.63684962,-85.17797541,20,3,17,"Fayette, IN",23102
457,18137,39.10235626,-85.26212744,88,3,85,"Ripley, IN",28324
458,39089,40.09136236,-82.48185785,88,3,85,"Licking, OH",176862
459,36077,42.63492579,-75.03151402,44,3,41,"Otsego, NY",59493
460,55039,43.75354908,-88.48885325,59,3,56,"Fond du Lac, WI",103403
461,47009,35.68938198,-83.92847788,47,3,44,"Blount, TN",133088
462,45061,34.16393091,-80.25690731,34,3,31,"Lee, SC",16828
463,18145,39.52305623,-85.79158570000001,79,3,76,"Shelby, IN",44729
464,42037,41.04821986,-76.40565017,131,3,128,"Columbia, PA",64964
465,12101,28.30810945,-82.40227529,186,3,183,"Pasco, FL",553947
466,37069,36.081519,-78.28708884,67,3,64,"Franklin, NC",69685
467,48039,29.18757369,-95.44563172,259,3,256,"Brazoria, TX",374264
468,55131,43.36863664,-88.22974712,78,3,75,"Washington, WI",136034
469,6089,40.76391419,-122.0396884,25,3,22,"Shasta, CA",180080
470,50011,44.85627605,-72.91249563,84,3,81,"Franklin, VT",49402
471,48477,30.21498498,-96.40946246,44,3,41,"Washington, TX",35882
472,39013,40.01625942,-80.9924051,58,3,55,"Belmont, OH",67006
473,12121,30.19746066,-82.99099670000003,80,3,77,"Suwannee, FL",44417
474,19171,42.07991767,-92.53266945,111,3,108,"Tama, IA",16854
475,48027,31.03736027,-97.4785025,110,3,107,"Bell, TX",362924
476,40097,36.30179091,-95.23175116,16,3,13,"Mayes, OK",41100
477,48309,31.55255453,-97.20217694,74,3,71,"McLennan, TX",256623
478,6047,37.18922369,-120.7209035,76,3,73,"Merced, CA",277680
479,36121,42.70145109,-78.22199579,42,3,39,"Wyoming, NY",39859
480,18109,39.47899078,-86.44573375,105,3,102,"Morgan, IN",70489
481,37125,35.30885257,-79.48474178,88,3,85,"Moore, NC",100880
482,21059,37.73028906,-87.09019479999998,89,3,86,"Daviess, KY",101511
483,24037,38.30058422,-76.60629279999998,99,3,96,"St. Mary's, MD",113510
484,12087,25.20904673,-81.07812416,66,3,63,"Monroe, FL",74228
485,13093,32.15630737,-83.79746561,52,3,49,"Dooly, GA",13390
486,45003,33.54338026,-81.63645384,60,3,57,"Aiken, SC",170872
487,12027,27.18677893,-81.80941373,22,3,19,"DeSoto, FL",38001
488,28033,34.87625235,-89.99091418,199,3,196,"DeSoto, MS",184945
489,45091,34.97281497,-81.18085944,138,3,135,"York, SC",280979
490,28001,31.47669768,-91.35326037,64,3,61,"Adams, MS",30693
491,40001,35.88494195,-94.65859267,29,3,26,"Adair, OK",22194
492,6053,36.21862405,-121.2413397,100,3,97,"Monterey, CA",434061
493,39007,41.70860332,-80.74830218,36,3,33,"Ashtabula, OH",97241
494,15009,20.86399628,-156.56890969999995,92,3,89,"Maui, HI",167417
495,48321,28.81955746,-96.01230294,51,3,48,"Matagorda, TX",36643
496,13069,31.54892966,-82.85492059999999,65,3,62,"Coffee, GA",43273
497,13185,30.83568832,-83.27056716,75,3,72,"Lowndes, GA",117406
498,1089,34.76327133,-86.55069633,191,3,188,"Madison, AL",372909
499,28089,32.63389156,-90.03513564,112,3,109,"Madison, MS",106272
500,28157,31.16078225,-91.31018819,51,3,48,"Wilkinson, MS",8630
501,40037,35.90230551,-96.37086028,57,3,54,"Creek, OK",71522
502,48139,32.34894117,-96.79371841,76,3,73,"Ellis, TX",184826
503,18039,41.59761169,-85.85875695,105,3,102,"Elkhart, IN",206341
504,6101,39.03417539,-121.6945899,24,3,21,"Sutter, CA",96971
505,13217,33.55514538,-83.84547140000002,104,3,101,"Newton, GA",111744
506,13013,33.99148694,-83.71436292,66,3,63,"Barrow, GA",83240
507,36053,42.91653905,-75.67266639,110,3,107,"Madison, NY",70941
508,39097,39.89381073,-83.40178317,24,3,21,"Madison, OH",44731
509,37195,35.70625477,-77.917978,79,3,76,"Wilson, NC",81801
510,12083,29.21227113,-82.05803627,107,3,104,"Marion, FL",365579
511,34011,39.37199394,-75.10712559,210,3,207,"Cumberland, NJ",149527
512,22009,31.07796211,-92.00079449,64,3,61,"Avoyelles, LA",40144
513,20031,38.2365018,-95.73379515,45,3,42,"Coffey, KS",8179
514,48365,32.163959600000005,-94.30552481,22,3,19,"Panola, TX",23194
515,21037,38.94384345,-84.37875208,47,3,44,"Campbell, KY",93584
516,37021,35.61113393,-82.53305,39,3,36,"Buncombe, NC",261191
517,23011,44.40759555,-69.76738544,93,3,90,"Kennebec, ME",122302
518,37025,35.3877799,-80.55267168,204,3,201,"Cabarrus, NC",216453
519,19103,41.67169354,-91.58754744,226,3,223,"Johnson, IA",151140
520,13129,34.50487351,-84.87296253,46,3,43,"Gordon, GA",57963
521,18173,38.08922676,-87.2716085,41,3,38,"Warrick, IN",62998
522,39165,39.42581994,-84.16557457,85,3,82,"Warren, OH",234602
523,26025,42.24633834,-85.00493569,104,3,101,"Calhoun, MI",134159
524,26055,44.69565625,-85.55585247,17,3,14,"Grand Traverse, MI",93088
525,29099,38.25926778,-90.53870896,139,3,136,"Jefferson, MO",225081
526,40125,35.20614018,-96.94923008,28,3,25,"Pottawatomie, OK",72592
527,48061,26.14524221,-97.48140372,239,3,236,"Cameron, TX",423163
528,40017,35.5426055,-97.98465569,63,3,60,"Canadian, OK",148306
529,36025,42.19837623,-74.96709306,46,3,43,"Delaware, NY",44135
530,13297,33.78017694,-83.73552314,52,3,49,"Walton, GA",94593
531,44007,41.87064746,-71.57753536,1957,3,1954,"Providence, RI",638931
532,18133,39.66437981,-86.84517605,42,3,39,"Putnam, IN",37576
533,41005,45.18787398,-122.2179634,142,3,139,"Clackamas, OR",418187
534,6025,33.0393082,-115.3669042,117,3,114,"Imperial, CA",181215
535,21047,36.89267803,-87.49055367,71,3,68,"Christian, KY",70461
536,17021,39.54581621,-89.27780482,24,3,21,"Christian, IL",32304
537,8051,38.66611652,-107.0320729,99,3,96,"Gunnison, CO",17462
538,18167,39.42944561,-87.39169027,43,3,40,"Vigo, IN",107038
539,28051,33.12345854,-90.08923538,52,3,49,"Holmes, MS",17010
540,37179,34.98960527,-80.52955873,115,3,112,"Union, NC",239859
541,8015,38.74745778,-106.19265729999998,28,3,25,"Chaffee, CO",20356
542,36043,43.42034246,-74.96145307,40,3,37,"Herkimer, NY",61319
543,36013,42.22769210000001,-79.36691763,24,3,21,"Chautauqua, NY",126903
544,27163,45.03864533,-92.88429635,88,3,85,"Washington, MN",262440
545,39041,40.27942393,-83.00457058,108,3,105,"Delaware, OH",209177
546,37071,35.29373559,-81.17477045,91,3,88,"Gaston, NC",224529
547,30101,48.65577551,-111.6942414,26,3,23,"Toole, MT",4736
548,36019,44.74530905,-73.67875352,45,3,42,"Clinton, NY",80485
549,42107,40.70497338,-76.2150785,212,3,209,"Schuylkill, PA",141359
550,20173,37.6842718,-97.4608198,209,3,206,"Sedgwick, KS",516042
551,6029,35.34329425,-118.7277796,533,3,530,"Kern, CA",900202
552,37161,35.40114178,-81.92112099,47,2,45,"Rutherford, NC",67029
553,19139,41.48370744,-91.1121697,133,2,131,"Muscatine, IA",42664
554,28053,33.12825718,-90.52252707,12,2,10,"Humphreys, MS",8064
555,21177,37.21425819,-87.14632053,47,2,45,"Muhlenberg, KY",30622
556,28035,31.18961454,-89.25832496,122,2,120,"Forrest, MS",74897
557,40101,35.61318461,-95.37802952,26,2,24,"Muskogee, OK",67997
558,38059,46.71681782,-101.2822377,21,2,19,"Morton, ND",31364
559,48381,34.96585996,-101.8971322,73,2,71,"Randall, TX",137713
560,19163,41.63935978,-90.61959493,129,2,127,"Scott, IA",172943
561,48329,31.86904128,-102.0315682,35,2,33,"Midland, TX",176832
562,1069,31.15197924,-85.29939599,54,2,52,"Houston, AL",105882
563,6055,38.50735751,-122.332839,38,2,36,"Napa, CA",137744
564,48189,34.07044901,-101.8268114,11,2,9,"Hale, TX",33406
565,37063,36.03638492,-78.87608331,349,2,347,"Durham, NC",321488
566,17113,40.48996987,-88.84621113,82,2,80,"McLean, IL",171517
567,35031,35.58007720000001,-108.262245,242,2,240,"McKinley, NM",71367
568,48349,32.04620681,-96.47428766,16,2,14,"Navarro, TX",50113
569,21145,37.05350953,-88.70445755,24,2,22,"McCracken, KY",65418
570,13225,32.56934316,-83.82937,24,2,22,"Peach, GA",27546
571,12109,29.90096506,-81.43589967,179,2,177,"St. Johns, FL",264672
572,47059,36.17470125,-82.84691273,27,2,25,"Greene, TN",69069
573,48231,33.12351514,-96.08551032,22,2,20,"Hunt, TX",98594
574,18143,38.68672078,-85.74627859,17,2,15,"Scott, IN",23873
575,21125,37.10975748,-84.11321779,11,2,9,"Laurel, KY",60813
576,45057,34.68270843,-80.70513032,68,2,66,"Lancaster, SC",98012
577,53039,45.87325839,-120.7913598,15,2,13,"Klickitat, WA",22425
578,22067,32.81686191,-91.80421614,32,2,30,"Morehouse, LA",24874
579,38089,46.80851182,-102.6576326,34,2,32,"Stark, ND",31489
580,8083,37.33859579,-108.5958857,12,2,10,"Montezuma, CO",26183
581,37085,35.36731853,-78.87243571,53,2,51,"Harnett, NC",135976
582,20125,37.19236568,-95.74329258,11,2,9,"Montgomery, KS",31829
583,18061,38.19467379,-86.10948271,59,2,57,"Harrison, IN",40515
584,28095,33.89236763,-88.4808438,46,2,44,"Monroe, MS",35252
585,26043,46.00999672,-87.86961634,3,2,1,"Dickinson, MI",25239
586,48203,32.54935988,-94.36934071,34,2,32,"Harrison, TX",66553
587,47073,36.44355426,-82.94885298,24,2,22,"Hawkins, TN",56786
588,18105,39.16130004,-86.52414358,95,2,93,"Monroe, IN",148431
589,40135,35.49447108,-94.75463785,10,2,8,"Sequoyah, OK",41569
590,50015,44.60353043,-72.64356694,22,2,20,"Lamoille, VT",25362
591,37167,35.31647813,-80.25093221,17,2,15,"Stanly, NC",62806
592,18111,40.95610449,-87.39635768,29,2,27,"Newton, IN",13984
593,12053,28.55364461,-82.42700204,76,2,74,"Hernando, FL",193920
594,22081,32.09530039,-93.34213308,13,2,11,"Red River, LA",8442
595,33011,42.91537785,-71.7200253,458,2,456,"Hillsborough, NH",417025
596,37157,36.39593137,-79.77504841,18,2,16,"Rockingham, NC",91010
597,28121,32.26469147,-89.94537876,113,2,111,"Rankin, MS",155271
598,54061,39.63218457,-80.04766838,83,2,81,"Monongalia, WV",105612
599,40131,36.37004357,-95.60406759,30,2,28,"Rogers, OK",92459
600,47125,36.49609412,-87.38550661,102,2,100,"Montgomery, TN",208993
601,46099,43.67441641,-96.7910885,934,2,932,"Minnehaha, SD",193134
602,8045,39.59921777,-107.902708,59,2,57,"Garfield, CO",60061
603,37151,35.71015088,-79.80570339,60,2,58,"Randolph, NC",143667
604,39057,39.69116283,-83.89032084,31,2,29,"Greene, OH",168937
605,28093,34.76216286,-89.50299462,35,2,33,"Marshall, MS",35294
606,26067,42.94502238,-85.07413319,18,2,16,"Ionia, MI",64697
607,45043,33.43443342,-79.33202141,33,2,31,"Georgetown, SC",62680
608,27109,44.00374114,-92.40209944,153,2,151,"Olmsted, MN",158293
609,28115,34.226046000000004,-89.03636807,15,2,13,"Pontotoc, MS",32174
610,48199,30.33364686,-94.38931817,65,2,63,"Hardin, TX",57602
611,6097,38.52746429,-122.8862506,160,2,158,"Sonoma, CA",494336
612,36037,43.0022601,-78.19135193,76,2,74,"Genesee, NY",57280
613,16053,42.68891267,-114.2655033,30,2,28,"Jerome, ID",24412
614,39143,41.35624126,-83.137872,13,2,11,"Sandusky, OH",58518
615,28107,34.36398677,-89.95064249,26,2,24,"Panola, MS",34192
616,6095,38.26827353,-121.9357113,140,2,138,"Solano, CA",447643
617,55087,44.41578887,-88.46565023,31,2,29,"Outagamie, WI",187885
618,5045,35.14719007,-92.33717519,58,2,56,"Faulkner, AR",126007
619,26151,43.42406072,-82.82055898,25,2,23,"Sanilac, MI",41170
620,6083,34.65329488,-120.0188492,313,2,311,"Santa Barbara, CA",446499
621,8097,39.21720112,-106.9310027,49,2,47,"Pitkin, CO",17767
622,53041,46.57756476,-122.3925769,19,2,17,"Lewis, WA",80707
623,6087,37.05580291,-122.0066524,96,2,94,"Santa Cruz, CA",273213
624,37135,36.06092947,-79.12167935,159,2,157,"Orange, NC",148476
625,12035,29.45933576,-81.31508595,46,2,44,"Flagler, FL",115081
626,26079,44.68512729,-85.09085699,16,2,14,"Kalkaska, MI",18038
627,28113,31.17507789,-90.40392572,72,2,70,"Pike, MS",39288
628,36075,43.42778894,-76.14635194,42,2,40,"Oswego, NY",117124
629,26155,42.95392800000001,-84.14585902,63,2,61,"Shiawassee, MI",68122
630,26137,45.02085831,-84.59898295,35,2,33,"Otsego, MI",24668
631,17093,41.59081014,-88.42869583,116,2,114,"Kendall, IL",128990
632,26139,42.95996803,-85.9969107,74,2,72,"Ottawa, MI",291830
633,18053,40.51587228,-85.65468702,41,2,39,"Grant, IN",65769
634,21143,37.02080035,-88.07886257,13,2,11,"Lyon, KY",8210
635,1087,32.38759944,-85.69267724,19,2,17,"Macon, AL",18068
636,6069,36.60308176,-121.069975,39,2,37,"San Benito, CA",62808
637,37097,35.80950511,-80.8743128,72,2,70,"Iredell, NC",181806
638,18055,39.03630547,-86.96223202,28,2,26,"Greene, IN",31922
639,1095,34.36975964,-86.30486727,106,2,104,"Marshall, AL",96774
640,21199,37.10466131,-84.57629079,31,2,29,"Pulaski, KY",64979
641,51710,36.89934014,-76.26420872,99,2,97,"Norfolk, VA",242742
642,55117,43.72099677,-87.94579284,37,2,35,"Sheboygan, WI",115340
643,48135,31.86898877,-102.5429428,46,2,44,"Ector, TX",166223
644,40117,36.31743373,-96.7033176,27,2,25,"Pawnee, OK",16376
645,20169,38.78369175,-97.65185177,13,2,11,"Saline, KS",54224
646,1071,34.78144169,-85.99750489,31,2,29,"Jackson, AL",51626
647,13227,34.46589159,-84.46406611,14,2,12,"Pickens, GA",32591
648,31119,41.91676024,-97.6005481,6,2,4,"Madison, NE",35099
649,47111,36.53157855,-86.00778595,27,2,25,"Macon, TN",24602
650,42075,40.36680311,-76.45651841,349,2,347,"Lebanon, PA",141793
651,51095,37.31156958,-76.76950618,132,2,130,"James City, VA",76523
652,12117,28.7158582,-81.24060348,283,2,281,"Seminole, FL",471826
653,48375,35.40133773,-101.893964,79,2,77,"Potter, TX",117415
654,53025,47.20753737,-119.4500749,122,2,120,"Grant, WA",97733
655,13229,31.35928155,-82.21598442,47,2,45,"Pierce, GA",19465
656,18127,41.45986947,-87.06848888,135,2,133,"Porter, IN",170389
657,17119,38.83042506,-89.90422563,135,2,133,"Madison, IL",262966
658,26047,45.52625509,-84.89083249,21,2,19,"Emmet, MI",33415
659,22041,32.13675181,-91.67589857,53,2,51,"Franklin, LA",20015
660,6039,37.21513971,-119.76655890000002,33,2,31,"Madera, CA",157327
661,28071,34.35687874,-89.48490961,36,2,34,"Lafayette, MS",54019
662,53021,46.53351425,-118.9018212,185,2,183,"Franklin, WA",95222
663,13007,31.32669878,-84.44218806,16,2,14,"Baker, GA",3038
664,26023,41.91600556,-85.05929476,30,2,28,"Branch, MI",43517
665,13037,31.53169785,-84.62725131,58,2,56,"Calhoun, GA",6189
666,21019,38.36176608,-82.68652187,24,2,22,"Boyd, KY",46718
667,46005,44.41464384,-98.27858469,21,2,19,"Beadle, SD",18453
668,28133,33.60192578,-90.58882684,42,2,40,"Sunflower, MS",25110
669,37051,35.04762133,-78.82623165,90,2,88,"Cumberland, NC",335509
670,19005,43.28383218,-91.37860922,24,2,22,"Allamakee, IA",13687
671,26017,43.70639106,-83.98731479,64,2,62,"Bay, MI",103126
672,12005,30.26548745,-85.62122584,39,2,37,"Bay, FL",174705
673,13085,34.44244079,-84.16964071,37,2,35,"Dawson, GA",26108
674,28017,33.91983202,-88.9481545,33,2,31,"Chickasaw, MS",17103
675,27167,46.35721532,-96.4684375,7,2,5,"Wilkin, MN",6207
676,1047,32.32688101,-87.10866709999998,18,2,16,"Dallas, AL",37196
677,39017,39.44012838,-84.57388716,133,2,131,"Butler, OH",383134
678,22127,31.94449367,-92.63789413,12,2,10,"Winn, LA",13904
679,37057,35.79115496,-80.21256572,90,2,88,"Davidson, NC",167609
680,37059,35.93099927,-80.54496571,23,2,21,"Davie, NC",42846
681,28013,33.93683395,-89.33686647,27,2,25,"Calhoun, MS",14361
682,5035,35.21247318,-90.30839406,121,2,119,"Crittenden, AR",47955
683,47003,35.51123746,-86.45549096,25,2,23,"Bedford, TN",49713
684,5141,35.58095779,-92.51295036,26,2,24,"Van Buren, AR",16545
685,38017,46.93201724,-97.2444719,135,2,133,"Cass, ND",181923
686,8119,38.88133511,-105.1614893,16,2,14,"Teller, CO",25388
687,23027,44.4858305,-69.12061935,30,2,28,"Waldo, ME",39715
688,24015,39.56647682,-75.94627411,90,2,88,"Cecil, MD",102855
689,39175,40.84339621,-83.30734173,14,2,12,"Wyandot, OH",21772
690,17019,40.13919438,-88.20046615,90,2,88,"Champaign, IL",209689
691,13269,32.55792548,-84.25077141,9,2,7,"Taylor, GA",8020
692,51013,38.8767675,-77.10139853,420,2,418,"Arlington, VA",236842
693,55127,42.66858202,-88.54163073,49,2,47,"Walworth, WI",103868
694,18157,40.38872739,-86.89413959,46,2,44,"Tippecanoe, IN",195732
695,45019,32.82487866,-79.96512315,360,2,358,"Charleston, SC",411406
696,42127,41.64938475,-75.29956506,75,2,73,"Wayne, PA",51361
697,21015,38.97065142,-84.72615357,56,2,54,"Boone, KY",133581
698,26159,42.25190229,-86.01939087,26,2,24,"Van Buren, MI",75677
699,37191,35.36438125,-78.00027268,87,2,85,"Wayne, NC",123131
700,49011,40.99001837,-112.1139997,217,2,215,"Davis, UT",355481
701,49049,40.1166722,-111.6657662,352,2,350,"Utah, UT",636235
702,13061,31.62221166,-84.97713865,16,2,14,"Clay, GA",2834
703,29047,39.31132056,-94.41850862,51,2,49,"Clay, MO",249948
704,13009,33.06882326,-83.24701748,90,2,88,"Baldwin, GA",44890
705,8003,37.57250606,-105.7885451,7,2,5,"Alamosa, CO",16233
706,8014,39.95998787,-105.0566324,88,2,86,"Broomfield, CO",70465
707,13029,32.00979311,-81.44002948,30,2,28,"Bryan, GA",39627
708,1003,30.72774991,-87.72207058,91,2,89,"Baldwin, AL",223234
709,50027,43.58010937,-72.58595157,27,2,25,"Windsor, VT",55062
710,36115,43.31153794,-73.43043448,42,2,40,"Washington, NY",61204
711,37187,35.83810081,-76.57299037,18,2,16,"Washington, NC",11580
712,13033,33.05917989,-81.99928721,28,2,26,"Burke, GA",22383
713,12003,30.33060121,-82.28467476,17,2,15,"Baker, FL",29210
714,28151,33.28392041,-90.94196237,62,2,60,"Washington, MS",43909
715,21029,37.97162523,-85.68955617,30,2,28,"Bullitt, KY",81676
716,29083,38.38482826,-93.79293734,5,1,4,"Henry, MO",21824
717,55075,45.38553432,-88.03324599999998,4,1,3,"Marinette, WI",40350
718,19087,40.98767962,-91.54436349,22,1,21,"Henry, IA",19954
719,47189,36.15496772,-86.29775884,145,1,144,"Wilson, TN",144657
720,18065,39.93029017,-85.39625719,23,1,22,"Henry, IN",47972
721,21151,37.71659336,-84.27220275,21,1,20,"Madison, KY",92987
722,39021,40.13923427,-83.76875242,6,1,5,"Champaign, OH",38885
723,37133,34.72607366,-77.42908179,36,1,35,"Onslow, NC",197938
724,54045,37.8299889,-81.93528571,8,1,7,"Logan, WV",32019
725,50003,43.03519828,-73.09048868,32,1,31,"Bennington, VT",35470
726,5125,34.64916145,-92.67583224,34,1,33,"Saline, AR",122437
727,18183,41.13863784,-85.50791236,14,1,13,"Whitley, IN",33964
728,1091,32.24767634,-87.78796182,23,1,22,"Marengo, AL",18863
729,5057,33.73325583,-93.66935133,4,1,3,"Hempstead, AR",21532
730,13149,33.29686567,-85.12886832,5,1,4,"Heard, GA",11923
731,47075,35.58332824,-89.28536625,12,1,11,"Haywood, TN",17304
732,55073,44.89792533,-89.75863384,14,1,13,"Marathon, WI",135692
733,48209,30.05669873,-98.02944344,103,1,102,"Hays, TX",230191
734,26029,45.37790017,-85.19614053,11,1,10,"Charlevoix, MI",26143
735,48467,32.56483801,-95.83766469,10,1,9,"Van Zandt, TX",56590
736,48215,26.39418217,-98.18299696,217,1,216,"Hidalgo, TX",868707
737,19011,42.08011739,-92.06463573,19,1,18,"Benton, IA",25645
738,29115,39.87001769,-93.10704106,5,1,4,"Linn, MO",11920
739,26027,41.91522292,-85.99405727,17,1,16,"Cass, MI",51787
740,51810,36.73285734,-76.04566934,256,1,255,"Virginia Beach, VA",449974
741,13021,32.80904227,-83.70489165,95,1,94,"Bibb, GA",153159
742,55043,42.8671731,-90.7063218,8,1,7,"Grant, WI",51439
743,37077,36.30337451,-78.65184241,99,1,98,"Granville, NC",60443
744,16031,42.28347888,-113.6012409,10,1,9,"Cassia, ID",24030
745,48069,34.53016752,-102.2617243,11,1,10,"Castro, TX",7530
746,18135,40.15734772,-85.01139319,11,1,10,"Randolph, IN",24665
747,48221,32.42990927,-97.83242024,15,1,14,"Hood, TX",61643
748,48469,28.79780988,-96.96813006,89,1,88,"Victoria, TX",92084
749,22025,31.66778967,-91.84526385,22,1,21,"Catahoula, LA",9494
750,18163,38.02658833,-87.58763124,65,1,64,"Vanderburgh, IN",181451
751,37035,35.66211129,-81.2132617,38,1,37,"Catawba, NC",159551
752,48219,33.60771256,-102.3431676,15,1,14,"Hockley, TX",23021
753,22115,31.10884837,-93.18153838,14,1,13,"Vernon, LA",47429
754,36011,42.91261714,-76.55731592,36,1,35,"Cayuga, NY",76576
755,48405,31.39457611,-94.17000399,9,1,8,"San Augustine, TX",8237
756,22113,29.83517605,-92.30292538,27,1,26,"Vermilion, LA",59511
757,37015,36.0688473,-76.96545943,16,1,15,"Bertie, NC",18947
758,26165,44.33853602,-85.57712739,7,1,6,"Wexford, MI",33631
759,37131,36.41736238,-77.39769443,69,1,68,"Northampton, NC",19483
760,37091,36.3607755,-76.98104134,4,1,3,"Hertford, NC",23677
761,39139,40.77180308,-82.53799609999999,44,1,43,"Richland, OH",121154
762,54033,39.2853852,-80.37919577,28,1,27,"Harrison, WV",67256
763,13133,33.5769205,-83.17139104,34,1,33,"Greene, GA",18324
764,13139,34.32207823,-83.81896936,374,1,373,"Hall, GA",204441
765,33015,42.98499744,-71.12883377,399,1,398,"Rockingham, NH",309769
766,26127,43.64124435,-86.26726673,3,1,2,"Oceana, MI",26467
767,37113,35.14867843,-83.41696617,2,1,1,"Macon, NC",35858
768,35006,34.91131525,-107.998876,29,1,28,"Cibola, NM",26675
769,13291,34.82995757,-83.98967069,8,1,7,"Union, GA",24511
770,48489,26.47411727,-97.61535848,5,1,4,"Willacy, TX",21358
771,26015,42.59513984,-85.30834519,18,1,17,"Barry, MI",61550
772,37193,36.2084135,-81.16232895,4,1,3,"Wilkes, NC",68412
773,47063,36.21990035,-83.26586179,6,1,5,"Hamblen, TN",64934
774,28019,33.34598242,-89.24809382,11,1,10,"Choctaw, MS",8210
775,47131,36.35732446,-89.14921589,8,1,7,"Obion, TN",30069
776,22011,30.64836518,-93.34173616,30,1,29,"Beauregard, LA",37497
777,37083,36.25669272,-77.6556109,30,1,29,"Halifax, NC",50010
778,18139,39.62002287,-85.4655599,17,1,16,"Rush, IN",16581
779,13137,34.63331566,-83.53094677,29,1,28,"Habersham, GA",45328
780,13195,34.12920917,-83.21218732,13,1,12,"Madison, GA",29880
781,30057,45.30080065,-111.9173017,8,1,7,"Madison, MT",8600
782,13319,32.80291082,-83.17140684,14,1,13,"Wilkinson, GA",8954
783,29013,38.25271289,-94.34113157,6,1,5,"Bates, MO",16172
784,27025,45.5021011,-92.90861945,7,1,6,"Chisago, MN",56579
785,48021,30.10370699,-97.31206354,32,1,31,"Bastrop, TX",88723
786,19121,41.33081904,-94.01554631,3,1,2,"Madison, IA",16338
787,48073,31.837258,-95.16559897,9,1,8,"Cherokee, TX",52646
788,51650,37.03513786,-76.35879121,75,1,74,"Hampton, VA",134510
789,51540,38.03527919,-78.48569588,38,1,37,"Charlottesville, VA",47266
790,24045,38.37301947,-75.62705831,76,1,75,"Wicomico, MD",103609
791,48359,35.40425596,-102.6027606,3,1,2,"Oldham, TX",2112
792,37153,35.00417719,-79.74491009,14,1,13,"Richmond, NC",44829
793,47061,35.38433717,-85.72142731,23,1,22,"Grundy, TN",13427
794,37037,35.70394416,-79.25541492,81,1,80,"Chatham, NC",74470
795,51830,37.28131268,-76.70905141,19,1,18,"Williamsburg, VA",14954
796,28105,33.42491685,-88.87905132,41,1,40,"Oktibbeha, MS",49587
797,13055,34.47197698,-85.34535662,8,1,7,"Chattooga, GA",24789
798,26035,43.98794227,-84.84819859999998,5,1,4,"Clare, MI",30950
799,13145,32.73709786,-84.90538572,25,1,24,"Harris, GA",35236
800,42009,40.00522157,-78.48998442,9,1,8,"Bedford, PA",47888
801,26031,45.44787015,-84.50122149,12,1,11,"Cheboygan, MI",25276
802,40021,35.90692775,-94.99980896,21,1,20,"Cherokee, OK",48657
803,36015,42.13891056,-76.7638805,69,1,68,"Chemung, NY",83456
804,40093,36.31149996,-98.53467076,2,1,1,"Major, OK",7629
805,12091,30.69143028,-86.59267105,107,1,106,"Okaloosa, FL",210738
806,13143,33.79602175,-85.21005667,19,1,18,"Haralson, GA",29792
807,13221,33.878629600000004,-83.08278123,19,1,18,"Oglethorpe, GA",15259
808,39063,41.00250487,-83.66838948,23,1,22,"Hancock, OH",75783
809,17141,42.04165196,-89.32184679,28,1,27,"Ogle, IL",50643
810,39171,41.56052014,-84.58429552,6,1,5,"Williams, OH",36692
811,48227,32.30621324,-101.4356444,1,1,0,"Howard, TX",36664
812,37039,35.1349263,-84.05970864,14,1,13,"Cherokee, NC",28612
813,18017,40.76135835,-86.34830753,33,1,32,"Cass, IN",37689
814,28145,34.49162015,-89.00776006,9,1,8,"Union, MS",28815
815,18009,40.47388153,-85.32499702,6,1,5,"Blackford, IN",11758
816,37031,34.8932941,-76.54120135,22,1,21,"Carteret, NC",69473
817,21195,37.47088263,-82.39487445,5,1,4,"Pike, KY",57876
818,31109,40.78416049,-96.68777155,57,1,56,"Lancaster, NE",319090
819,49053,37.3225,-113.4776,47,1,46,"Washington, UT",177556
820,21031,37.20946153,-86.68748787,24,1,23,"Butler, KY",12879
821,41039,43.93727035,-122.847753,44,1,43,"Lane, OR",382067
822,13173,31.03828570000001,-83.06472457,5,1,4,"Lanier, GA",10423
823,13025,31.19576557,-81.97743999,13,1,12,"Brantley, GA",19109
824,55057,43.92456975,-90.11120239,7,1,6,"Juneau, WI",26687
825,37147,35.59535426,-77.37353178,72,1,71,"Pitt, NC",180742
826,41033,42.3665549,-123.5561938,19,1,18,"Josephine, OR",87487
827,40121,34.92065823,-95.7513432,13,1,12,"Pittsburg, OK",43654
828,37103,35.02254606,-77.35870791,9,1,8,"Jones, NC",9419
829,40077,34.87844729,-95.25215049,4,1,3,"Latimer, OK",10073
830,40015,35.17364557,-98.37534464,35,1,34,"Caddo, OK",28762
831,1129,31.4092794,-88.20689944,12,1,11,"Washington, AL",16326
832,47011,35.15739424,-84.857186,33,1,32,"Bradley, TN",108110
833,56019,44.04057166,-106.5845174,11,1,10,"Johnson, WY",8445
834,48251,32.37877812,-97.36615819,34,1,33,"Johnson, TX",175817
835,55135,44.47068056,-88.96534501,4,1,3,"Waupaca, WI",50990
836,13175,32.46325233,-82.92221316,35,1,34,"Laurens, GA",47546
837,45059,34.48244419,-82.00490796,14,1,13,"Laurens, SC",67493
838,16075,44.00545243,-116.7647695,9,1,8,"Payette, ID",23951
839,5075,36.04188196,-91.10867198,11,1,10,"Lawrence, AR",16406
840,13167,32.70211082,-82.66166794,21,1,20,"Johnson, GA",9643
841,12007,29.95079741,-82.16611613,35,1,34,"Bradford, FL",28201
842,18177,39.8633444,-85.01044989,20,1,19,"Wayne, IN",65884
843,13165,32.79248718,-81.96040187,12,1,11,"Jenkins, GA",8676
844,13027,30.83922642,-83.58303423,21,1,20,"Brooks, GA",15457
845,24043,39.60835778,-77.82002295,106,1,105,"Washington, MD",151049
846,24029,39.24976208,-76.04741541,11,1,10,"Kent, MD",19422
847,29021,39.65816401,-94.80138942,22,1,21,"Buchanan, MO",87364
848,37019,34.070565,-78.22814204,35,1,34,"Brunswick, NC",142820
849,18087,41.64232188,-85.42674232,14,1,13,"LaGrange, IN",39614
850,42099,40.40206612,-77.26297447,17,1,16,"Perry, PA",46272
851,28111,31.17161885,-88.99281835,20,1,19,"Perry, MS",11973
852,18085,41.24521668,-85.86312322,19,1,18,"Kosciusko, IN",79456
853,55009,44.4526553,-88.00411844,114,1,113,"Brown, WI",264542
854,29107,39.06986886,-93.78076396,28,1,27,"Lafayette, MO",32708
855,39083,40.39830217,-82.42027563,10,1,9,"Knox, OH",62322
856,48049,31.77430356,-98.99907113,11,1,10,"Brown, TX",37864
857,42125,40.19208869,-80.24582867,71,1,70,"Washington, PA",206865
858,5107,34.43268455,-90.84800154,4,1,3,"Phillips, AR",17782
859,39015,38.93416837,-83.86788395,8,1,7,"Brown, OH",43432
860,48273,27.42435506,-97.69894948,3,1,2,"Kleberg, TX",30680
861,28073,31.20572971,-89.5077704,48,1,47,"Lamar, MS",63343
862,27015,44.24205652,-94.72562874,7,1,6,"Brown, MN",25008
863,18013,39.19605589,-86.22868909,14,1,13,"Brown, IN",15092
864,53035,47.63479026,-122.6436061,132,1,131,"Kitsap, WA",271473
865,8063,39.30497777,-102.6022199,8,1,7,"Kit Carson, CO",7097
866,6031,36.07409056,-119.8159973,13,1,12,"Kings, CA",152940
867,31019,40.85486962,-99.07500296,38,1,37,"Buffalo, NE",49659
868,55011,44.37835084,-91.75332578,4,1,3,"Buffalo, WI",13031
869,55061,44.51727459,-87.61468386,5,1,4,"Kewaunee, WI",20434
870,17143,40.78702156,-89.76078901,33,1,32,"Peoria, IL",179179
871,13031,32.39577406,-81.74811421,22,1,21,"Bulloch, GA",79608
872,13231,33.09310242,-84.38790389,25,1,24,"Pike, GA",18962
873,46103,44.0025835,-102.8240777,9,1,8,"Pennington, SD",113775
874,28065,31.56884708,-89.82670990000004,7,1,6,"Jefferson Davis, MS",11128
875,45017,33.66926881,-80.77722168,5,1,4,"Calhoun, SC",14553
876,28079,32.7536828,-89.52402044,40,1,39,"Leake, MS",22786
877,42063,40.65241041,-79.08963285,43,1,42,"Indiana, PA",84073
878,13157,34.13794553,-83.56814788,33,1,32,"Jackson, GA",72977
879,51153,38.70916224,-77.48713689,536,1,535,"Prince William, VA",470335
880,8091,38.14717457,-107.7675136,4,1,3,"Ouray, CO",4952
881,13235,32.23334561,-83.47549959999998,11,1,10,"Pulaski, GA",11137
882,55051,46.26302338,-90.24295041,2,1,1,"Iron, WI",5687
883,17015,42.06823429,-89.93395545,5,1,4,"Carroll, IL",14305
884,29169,37.82462075,-92.20783203,16,1,15,"Pulaski, MO",52607
885,18015,40.580783200000006,-86.56198812,6,1,5,"Carroll, IN",20257
886,48293,31.5454767,-96.58095444,11,1,10,"Limestone, TX",23437
887,12107,29.60779729,-81.74230285,46,1,45,"Putnam, FL",74521
888,26069,44.35486835,-83.63484895,4,1,3,"Iosco, MI",25127
889,28155,33.61300486,-89.28392912,14,1,13,"Webster, MS",9689
890,12061,27.69308961,-80.60556721,78,1,77,"Indian River, FL",159923
891,18119,39.31145587,-86.83900724,19,1,18,"Owen, IN",20799
892,28023,32.04158545,-88.68896219999998,19,1,18,"Clarke, MS",15541
893,37183,35.78879266,-78.65249174,537,1,536,"Wake, NC",1111761
894,39077,41.14651175,-82.59867951,14,1,13,"Huron, OH",58266
895,18069,40.82907273,-85.48822092,6,1,5,"Huntington, IN",36520
896,24035,39.06198912,-76.03530977,19,1,18,"Queen Anne's, MD",50381
897,29113,39.05345619,-90.95588181,35,1,34,"Lincoln, MO",59013
898,29035,36.94160441,-90.96051322,3,1,2,"Carter, MO",5982
899,13239,31.86728114,-85.01773177,3,1,2,"Quitman, GA",2299
900,30053,48.54265777,-115.4046155,7,1,6,"Lincoln, MT",19980
901,32013,41.40692186,-118.1109427,20,1,19,"Humboldt, NV",16831
902,31111,41.04658298,-100.7475374,17,1,16,"Lincoln, NE",34914
903,47019,36.28969086,-82.12588974,3,1,2,"Carter, TN",56391
904,29031,37.38489388,-89.6843587,30,1,29,"Cape Girardeau, MO",78871
905,38101,48.22390169,-101.5436763,20,1,19,"Ward, ND",67641
906,41053,44.90322804,-123.4128888,30,1,29,"Polk, OR",86085
907,28149,32.35810271,-90.83352619,15,1,14,"Warren, MS",45381
908,20103,39.20183497,-95.03620809,95,1,94,"Leavenworth, KS",81758
909,48037,33.44626922,-94.41834132,37,1,36,"Bowie, TX",93245
910,5077,34.78498904,-90.78383866,3,1,2,"Lee, AR",8857
911,21017,38.2054607,-84.21827874,4,1,3,"Bourbon, KY",19788
912,40123,34.72959848,-96.68337199,10,1,9,"Pontotoc, OK",38284
913,29027,38.83674754,-91.92186505,20,1,19,"Callaway, MO",44743
914,20011,37.85508555,-94.84865997,7,1,6,"Bourbon, KS",14534
915,21035,36.62093411,-88.2731593,15,1,14,"Calloway, KY",39001
916,24009,38.53961642,-76.56820632,102,1,101,"Calvert, MD",92525
917,42021,40.49527404,-78.71377428,14,1,13,"Cambria, PA",130192
918,13163,33.05867328,-82.41609057,7,1,6,"Jefferson, GA",15362
919,12065,30.43669112,-83.89442308,22,1,21,"Jefferson, FL",14246
920,29029,38.02199522,-92.76083747,26,1,25,"Camden, MO",46305
921,39135,39.7420247,-84.64787018,20,1,19,"Preble, OH",40882
922,29019,38.99186229,-92.30723575,87,1,86,"Boone, MO",180463
923,48241,30.74685667,-94.02667579,7,1,6,"Jasper, TX",35529
924,48363,32.75310985,-98.31319001,7,1,6,"Palo Pinto, TX",29189
925,19155,41.33640314,-95.53907776,14,1,13,"Pottawattamie, IA",93206
926,18171,40.34728141,-87.35602659,3,1,2,"Warren, IN",8265
927,18073,41.02078733,-87.11553319,19,1,18,"Jasper, IN",33562
928,17079,39.01054275,-88.15437049,3,1,2,"Jasper, IL",9610
929,17007,42.32359279,-88.82345779,16,1,15,"Boone, IL",53544
930,55053,44.31864893,-90.80566792,10,1,9,"Jackson, WI",20643
931,54035,38.84263974,-81.68148753,33,1,32,"Jackson, WV",28576
932,53065,48.40035475,-117.8542701,7,1,6,"Stevens, WA",45723
933,19157,41.68625425,-92.53155731,6,1,5,"Poweshiek, IA",18504
934,12129,30.16548905,-84.39895211,13,1,12,"Wakulla, FL",33739
935,17099,41.34426129999999,-88.88633881,24,1,23,"LaSalle, IL",108669
936,6103,40.12570935,-122.2370171,1,1,0,"Tehama, CA",65084
937,13277,31.45743864,-83.5236119,74,1,73,"Tift, GA",40644
938,42005,40.81665618,-79.46290811,29,1,28,"Armstrong, PA",64735
939,47051,35.15634626,-86.09201039,23,1,22,"Franklin, TN",42208
940,45029,32.87582989,-80.67641292,21,1,20,"Colleton, SC",37677
941,42117,41.77255149,-77.25433032,13,1,12,"Tioga, PA",40591
942,21149,37.5301951,-87.26803443,6,1,5,"McLean, KY",9207
943,26113,44.33772443,-85.09256478,2,1,1,"Missaukee, MI",15118
944,29187,37.81214171,-90.47598685,23,1,22,"St. Francois, MO",67215
945,1043,34.13020303,-86.86888037,40,1,39,"Cullman, AL",83768
946,35015,32.47167456,-104.3053527,7,1,6,"Eddy, NM",58460
947,53067,46.9291895,-122.8290656,82,1,81,"Thurston, WA",290536
948,8025,38.32608609,-103.7844965,2,1,1,"Crowley, CO",6061
949,37065,35.91230639,-77.59436892,36,1,35,"Edgecombe, NC",51472
950,24001,39.62357628,-78.69280486,17,1,16,"Allegany, MD",70416
951,55021,43.46492199,-89.33589004,27,1,26,"Columbia, WI",57532
952,37047,34.26744084,-78.65801424,40,1,39,"Columbus, NC",55508
953,21211,38.21476019,-85.194223,19,1,18,"Shelby, KY",49024
954,36003,42.25748406,-78.02750466,28,1,27,"Allegany, NY",46091
955,40139,36.74777635,-101.4889765,9,1,8,"Texas, OK",19983
956,13103,32.36616021,-81.34280942,25,1,24,"Effingham, GA",64296
957,17049,39.05935711,-88.58969584,3,1,2,"Effingham, IL",34008
958,30063,47.03728583,-113.92135079999998,30,1,29,"Missoula, MT",119600
959,37127,35.96575634,-77.98422508,42,1,41,"Nash, NC",94298
960,17135,39.23198845,-89.47809254,9,1,8,"Montgomery, IL",28414
961,20191,37.23682549,-97.47721621,2,1,1,"Sumner, KS",22836
962,46087,43.6742571,-97.36863144,3,1,2,"McCook, SD",5586
963,13251,32.74976524,-81.60779441,9,1,8,"Screven, GA",13966
964,45065,33.90161443,-82.30794338,4,1,3,"McCormick, SC",9463
965,37123,35.33155144,-79.90416657,16,1,15,"Montgomery, NC",27173
966,31067,40.26186809,-96.68946704,26,1,25,"Gage, NE",21513
967,19061,42.46815349,-90.88181925,37,1,36,"Dubuque, IA",97311
968,13253,30.93464824,-84.86823924,16,1,15,"Seminole, GA",8090
969,40133,35.16478725,-96.61686741,7,1,6,"Seminole, OK",24258
970,1033,34.69847452,-87.80168544,11,1,10,"Colbert, AL",55241
971,39147,41.12351311,-83.12783209,11,1,10,"Seneca, OH",55178
972,28163,32.77890365,-90.39656148,65,1,64,"Yazoo, MS",29690
973,4017,35.3997715,-110.3218983,390,1,389,"Navajo, AZ",110924
974,51510,38.814003,-77.08183073,254,1,253,"Alexandria, VA",159428
975,26149,41.91441767,-85.52797979,22,1,21,"St. Joseph, MI",60964
976,47163,36.51240691,-82.30412917,43,1,42,"Sullivan, TN",158348
977,38049,48.23104458,-100.6324822,1,1,0,"McHenry, ND",5745
978,4025,34.59933926,-112.5538588,66,1,65,"Yavapai, AZ",235099
979,13083,34.854916700000004,-85.50490424,3,1,2,"Dade, GA",16116
980,8117,39.63803232,-106.1150762,74,1,73,"Summit, CO",31011
981,21163,37.96163597,-86.21028219,2,1,1,"Meade, KY",28572
982,1059,34.44235334,-87.84289505,14,1,13,"Franklin, AL",31362
983,5043,33.59035001,-91.71777921,6,1,5,"Drew, AR",18219
984,26111,43.64330771,-84.38804374,36,1,35,"Midland, MI",83156
985,27171,45.17297924,-93.96234781,21,1,20,"Wright, MN",138377
986,20037,37.50675523,-94.85245778,6,1,5,"Crawford, KS",38818
987,19047,42.03718237,-95.3819718,6,1,5,"Crawford, IA",16820
988,24041,38.76618159,-76.10882561,14,1,13,"Talbot, MD",37181
989,39107,40.54043046,-84.62912742,13,1,12,"Mercer, OH",41172
990,48441,32.30163422,-99.89007449,74,1,73,"Taylor, TX",138034
991,28129,32.01744532,-89.50644846,36,1,35,"Smith, MS",15916
992,1121,33.37823223,-86.16886178,38,1,37,"Talladega, AL",79978
993,17051,39.00072038,-89.02452658,12,1,11,"Fayette, IL",21336
994,37049,35.11833364,-77.08398081,31,1,30,"Craven, NC",102139
995,18045,40.12361933,-87.24217689,3,1,2,"Fountain, IN",16346
996,48423,32.37474036,-95.2717568,103,1,102,"Smith, TX",232751
997,29213,36.65465345,-93.04075153,8,1,7,"Taney, MO",55928
998,2090,64.80726247,-146.5692662,79,1,78,"Fairbanks North Star, AK",96849
999,28005,31.17467303,-90.80501621,15,1,14,"Amite, MS",12297
1000,20035,37.23781842,-96.83776647,1,1,0,"Cowley, KS",34908
1001,39045,39.75107189,-82.63088163,92,1,91,"Fairfield, OH",157574
1002,42109,40.77129231,-77.06840691,24,1,23,"Snyder, PA",40372
1003,21005,38.00671029,-84.99171713,4,1,3,"Anderson, KY",22747
1004,47001,36.12684348,-84.19965764,15,1,14,"Anderson, TN",76978
1005,37197,36.16222629,-80.66239436,11,1,10,"Yadkin, NC",37667
1006,39043,41.36796058,-82.62904521,16,1,15,"Erie, OH",74266
1007,23001,44.1664747,-70.20380627,31,1,30,"Androscoggin, ME",108277
1008,26039,44.68255561,-84.61006219,16,1,15,"Crawford, MI",14029
1009,42115,41.82147784,-75.80071959,40,1,39,"Susquehanna, PA",40328
1010,19007,40.74324454,-92.86865906,1,1,0,"Appanoose, IA",12426
1011,22029,31.44817835,-91.63814433,21,1,20,"Concordia, LA",19259
1012,48107,33.61431553,-101.3000364,1,1,0,"Crosby, TX",5737
1013,8039,39.28656773,-104.1358721,17,1,16,"Elbert, CO",26729
1014,26107,43.64064262,-85.32463223,11,1,10,"Mecosta, MI",43453
1015,48325,29.3557301,-99.11030298,13,1,12,"Medina, TX",51584
1016,32007,41.14531606,-115.3577619,11,1,10,"Elko, NV",52778
1017,13081,31.92289565,-83.76811843,88,1,87,"Crisp, GA",22372
1018,17053,40.59706922,-88.22350769,4,1,3,"Ford, IL",12961
1019,5029,35.26205537,-92.70506566,5,1,4,"Conway, AR",20846
1020,13263,32.69642758,-84.53351366,12,1,11,"Talbot, GA",6195
1021,21213,36.74058474,-86.58047435,17,1,16,"Simpson, KY",18572
1022,1037,32.93690146,-86.24847739,19,1,18,"Coosa, AL",10663
1023,38029,46.28398398,-100.2389766,1,1,0,"Emmons, ND",3241
1024,30029,48.29575866,-114.0520569,37,1,36,"Flathead, MT",103806
1025,20055,38.04340344,-100.7381938,18,1,17,"Finney, KS",36467
1026,17137,39.71654544,-90.20255104,10,1,9,"Morgan, IL",33658
1027,48143,32.23602653,-98.21773417,13,1,12,"Erath, TX",42698
1028,28099,32.75339664,-89.11726492,35,1,34,"Neshoba, MS",29118
1029,29051,38.50455671,-92.27860244,38,1,37,"Cole, MO",76745
1030,18149,41.27890281,-86.64686895,10,1,9,"Starke, IN",22995
1031,18033,41.39804622,-84.99906934,6,1,5,"DeKalb, IN",43475
1032,37045,35.33553364,-81.55204486,40,1,39,"Cleveland, NC",97947
1033,13249,32.2654021,-84.31258912,13,1,12,"Schley, GA",5257
1034,55001,43.96974651,-89.76782777,3,1,2,"Adams, WI",20220
1035,50001,44.03217337,-73.14130877,56,1,55,"Addison, VT",36777
1036,13131,30.87454847,-84.23418364,21,1,20,"Grady, GA",24633
1037,40051,35.0167709,-97.88339847,14,1,13,"Grady, OK",55834
1038,55139,44.06886922,-88.64477096,31,1,30,"Winnebago, WI",171907
1039,26117,43.31082541,-85.15252824,23,1,22,"Montcalm, MI",63888
1040,51700,37.08166899,-76.51754109,95,1,94,"Newport News, VA",179225
1041,13207,33.014289,-83.92097166,13,1,12,"Monroe, GA",27578
1042,54049,39.50984542,-80.24244659,41,1,40,"Marion, WV",56072
1043,45071,34.28629098,-81.59935761,16,1,15,"Newberry, SC",38440
1044,47115,35.12997174,-85.62265895,26,1,25,"Marion, TN",28907
1045,45067,34.07859748,-79.36400756,8,1,7,"Marion, SC",30657
1046,21001,37.10459774,-85.28129668,43,1,42,"Adair, KY",19202
1047,18023,40.30319754,-86.47277257,13,1,12,"Clinton, IN",32399
1048,13279,32.12059861,-82.32957247,16,1,15,"Toombs, GA",26830
1049,39011,40.55998859,-84.22421429999999,18,1,17,"Auglaize, OH",45656
1050,9015,41.82972709,-71.98182316,89,1,88,"Windham, CT",116782
1051,28097,33.49419589,-89.61729103,15,1,14,"Montgomery, MS",9775
1052,27027,46.89289518,-96.48761922,43,1,42,"Clay, MN",64222
1053,50025,42.986982,-72.71268875,57,1,56,"Windham, VT",42222
1054,6115,39.26255932,-121.3535644,15,1,14,"Yuba, CA",78668
1055,27103,44.35291112,-94.24710352,7,1,6,"Nicollet, MN",34274
1056,19043,42.84443388,-91.34133693,7,1,6,"Clayton, IA",17549
1057,1001,32.53952745,-86.64408227,24,1,23,"Autauga, AL",55869
1058,55081,43.94641218,-90.618819,10,1,9,"Monroe, WI",46253
1059,47169,36.39026213,-86.16087954,20,1,19,"Trousdale, TN",11284
1060,18151,41.64423868,-85.00101094,13,1,12,"Steuben, IN",34594
1061,47117,35.45798777,-86.76420988,9,1,8,"Marshall, TN",34375
1062,26053,46.40862701,-89.69377193,4,1,3,"Gogebic, MI",13975
1063,29186,37.89090059,-90.1949941,7,1,6,"Ste. Genevieve, MO",17894
1064,18001,40.7457653,-84.93671406,6,1,5,"Adams, IN",35777
1065,51199,37.24374789,-76.54412815,35,1,34,"York, VA",68280
1066,42001,39.87140411,-77.21610347,64,1,63,"Adams, PA",103009
1067,39025,39.04847534,-84.15375786,49,1,48,"Clermont, OH",206428
1068,12043,26.95635849,-81.18996211,5,1,4,"Glades, FL",13811
1069,28143,34.64967704,-90.37481167,23,1,22,"Tunica, MS",9632
1070,40137,34.48556989,-97.85141892,15,1,14,"Stephens, OK",43143
1071,55027,43.41576662,-88.70928178,19,1,18,"Dodge, WI",87839
1072,13287,31.71612656,-83.62069378,41,1,40,"Turner, GA",7985
1073,18113,41.39672484,-85.41966713,25,1,24,"Noble, IN",47744
1074,22007,29.89946234,-91.06461642,129,1,128,"Assumption, LA",21891
1075,48115,32.74255572,-101.9477242,8,1,7,"Dawson, TX",12728
1076,6051,37.93899289,-118.8872409,23,1,22,"Mono, CA",14444
1077,39009,39.33425634,-82.04278644,3,1,2,"Athens, OH",65327
1078,21081,38.64962758,-84.62415957,14,1,13,"Grant, KY",25069
1079,40047,36.3791334,-97.78265517,7,1,6,"Garfield, OK",61056
1080,36057,42.90123494,-74.44011632,32,1,31,"Montgomery, NY",49221
1081,8029,38.86246243,-107.8631342,12,1,11,"Delta, CO",31162
1082,18027,38.70186039,-87.07185406,21,1,20,"Daviess, IN",33351
1083,6057,39.30394768,-120.7627281,34,1,33,"Nevada, CA",99755
1084,53017,47.7361335,-119.692937,29,1,28,"Douglas, WA",43429
1085,39053,38.82708533,-82.31647569,8,1,7,"Gallia, OH",29898
1086,37055,35.66520691,-75.71767334,15,1,14,"Dare, NC",37009
1087,27139,44.6490231,-93.53340251,20,1,19,"Scott, MN",149013
1088,26041,45.90484910000001,-86.9080745,9,1,8,"Delta, MI",35784
1089,45035,33.0794369,-80.40502652,78,1,77,"Dorchester, SC",162809
1090,28027,34.22772299,-90.60415045,43,1,42,"Coahoma, MS",22124
1091,35013,32.35275771,-106.83293870000001,54,1,53,"Dona Ana, NM",218195
1092,17037,41.89373302,-88.76958483,37,1,36,"DeKalb, IL",104897
1093,1099,31.56729412,-87.36995001,7,1,6,"Monroe, AL",20733
1094,55029,44.95856458,-87.30002707,9,1,8,"Door, WI",27668
1095,48451,31.40464436,-100.462443,40,1,39,"Tom Green, TX",119200
1096,24019,38.45413522,-76.02752426,16,1,15,"Dorchester, MD",31929
1097,37129,34.25758282,-77.87075626,63,1,62,"New Hanover, NC",234473
1098,6079,35.38822029,-120.4039028,120,1,119,"San Luis Obispo, CA",283111
1099,8093,39.120926,-105.7182065,6,0,6,"Park, CO",18845
1100,2290,65.50815459,-151.3907387,1,0,1,"Yukon-Koyukuk, AK",5230
1101,31179,42.20934475,-97.11926964,1,0,1,"Wayne, NE",9385
1102,8125,40.00346839,-102.4258673,2,0,2,"Yuma, CO",10019
1103,21175,37.92465657,-83.25558245,1,0,1,"Morgan, KY",13309
1104,21173,38.03253032,-83.9145241,8,0,8,"Montgomery, KY",28157
1105,30067,45.48965095,-110.52643940000002,7,0,7,"Park, MT",16606
1106,23017,44.49952995,-70.75682123,13,0,13,"Oxford, ME",57975
1107,36117,43.15494365,-77.02976528,48,0,48,"Wayne, NY",89918
1108,54109,37.612327,-81.54511071,1,0,1,"Wyoming, WV",20394
1109,53049,46.55418369,-123.7285716,1,0,1,"Pacific, WA",22471
1110,47181,35.23868267,-87.78644456,2,0,2,"Wayne, TN",16673
1111,42131,41.51955538,-76.01074915,13,0,13,"Wyoming, PA",26794
1112,18123,38.07809328,-86.63741946,4,0,4,"Perry, IN",19169
1113,19145,40.7393172,-95.1497813,3,0,3,"Page, IA",15107
1114,51139,38.61807452,-78.48797204,6,0,6,"Page, VA",23902
1115,19137,41.03018714,-95.15642896,1,0,1,"Montgomery, IA",9917
1116,51197,36.91582035,-81.07834059,7,0,7,"Wythe, VA",28684
1117,21193,37.25023553,-83.22922731,4,0,4,"Perry, KY",25758
1118,4027,32.76895712,-113.90666740000002,20,0,20,"Yuma, AZ",213787
1119,37137,35.15253315,-76.66559823,6,0,6,"Pamlico, NC",12726
1120,47179,36.29472368,-82.49454720000001,44,0,44,"Washington, TN",129375
1121,53051,48.53234021,-117.2741804,1,0,1,"Pend Oreille, WA",13724
1122,17145,38.08510853,-89.36856219,1,0,1,"Perry, IL",20916
1123,31185,40.87272618,-97.59710186,4,0,4,"York, NE",13679
1124,29139,38.94022054,-91.47000721,6,0,6,"Montgomery, MO",11551
1125,55091,44.58307413,-91.99949611,0,0,0,"Pepin, WI",7287
1126,40119,36.07695283,-96.97584944,29,0,29,"Payne, OK",81784
1127,42093,41.03023987,-76.66345939,44,0,44,"Montour, PA",18230
1128,23019,45.40194593,-68.65020455,36,0,36,"Penobscot, ME",152148
1129,26119,45.0275929,-84.12696227,1,0,1,"Montmorency, MI",9328
1130,51121,37.17746986,-80.37868691,34,0,34,"Montgomery, VA",98535
1131,54071,38.68314479,-79.35084086,1,0,1,"Pendleton, WV",6969
1132,21189,37.42823949,-83.68811419,2,0,2,"Owsley, KY",4415
1133,21191,38.69607718,-84.35599463,3,0,3,"Pendleton, KY",14590
1134,5149,35.00292371,-93.41171338,1,0,1,"Yell, AR",21341
1135,27165,43.97823903,-94.61413846,4,0,4,"Watonwan, MN",10897
1136,30111,45.93955949,-108.2691486,64,0,64,"Yellowstone, MT",161300
1137,48371,30.78097267,-102.7241261,5,0,5,"Pecos, TX",15823
1138,37189,36.23103603,-81.70033724,8,0,8,"Watauga, NC",56177
1139,29155,36.2130572,-89.78742322,8,0,8,"Pemiscot, MO",15805
1140,51191,36.72341572,-81.95666289,27,0,27,"Washington, VA",53740
1141,27173,44.71710183,-95.86842453,3,0,3,"Yellow Medicine, MN",9709
1142,37141,34.52265624,-77.90352133,5,0,5,"Pender, NC",63060
1143,55137,44.11324419,-89.24317107,2,0,2,"Waushara, WI",24443
1144,36123,42.63505484,-77.10369919,6,0,6,"Yates, NY",24913
1145,5105,34.9459153,-92.94372564,2,0,2,"Perry, AR",10455
1146,39125,41.11676341,-84.5801017,5,0,5,"Paulding, OH",18672
1147,13211,33.59232073,-83.49129491,15,0,15,"Morgan, GA",19276
1148,8087,40.26279810000001,-103.8093302,89,0,89,"Morgan, CO",29068
1149,1103,34.45500589,-86.85475946,42,0,42,"Morgan, AL",119679
1150,28161,34.02824175,-89.70762049999998,14,0,14,"Yalobusha, MS",12108
1151,46135,43.00924485,-97.39467635,22,0,22,"Yankton, SD",22814
1152,48503,33.17659707,-98.68790885,3,0,3,"Young, TX",18010
1153,28153,31.64135687,-88.69573913,9,0,9,"Wayne, MS",20183
1154,48341,35.83769242,-101.8930281,52,0,52,"Moore, TX",20940
1155,47127,35.27724699,-86.36230578,0,0,0,"Moore, TN",6488
1156,56029,44.52157546,-109.5852825,1,0,1,"Park, WY",29194
1157,18121,39.77202286,-87.20375833,7,0,7,"Parke, IN",16937
1158,48367,32.77757172,-97.80500621,16,0,16,"Parker, TX",142878
1159,50023,44.27343241,-72.61604978,29,0,29,"Washington, VT",58409
1160,21231,36.80310688,-84.8251971,5,0,5,"Wayne, KY",20333
1161,1105,32.64048341,-87.29770589,7,0,7,"Perry, AL",8923
1162,37139,36.26723798,-76.25134778,15,0,15,"Pasquotank, NC",39824
1163,51141,36.6801638,-80.2865648,0,0,0,"Patrick, VA",17608
1164,13305,31.5521809,-81.91894878,6,0,6,"Wayne, GA",29927
1165,37143,36.17847453,-76.40603143,12,0,12,"Perquimans, NC",13463
1166,16073,42.58016894,-116.1693871,4,0,4,"Owyhee, ID",11823
1167,29147,40.36079813,-94.88133008,3,0,3,"Nodaway, MO",22092
1168,29141,38.4181765,-92.88791859,1,0,1,"Morgan, MO",20627
1169,13315,31.97496928,-83.43438555,29,0,29,"Wilcox, GA",8635
1170,12093,27.386336199999995,-80.88944347,5,0,5,"Okeechobee, FL",42168
1171,53047,48.54855019,-119.7387224,15,0,15,"Okanogan, WA",42243
1172,5099,33.66340119,-93.30632432,1,0,1,"Nevada, AR",8252
1173,48487,34.07945812,-99.24178437,1,0,1,"Wilbarger, TX",12769
1174,54069,40.0955451,-80.62203992,22,0,22,"Ohio, WV",41411
1175,21183,37.47751843,-86.85368087,7,0,7,"Ohio, KY",23994
1176,18115,38.955305,-84.96515993,1,0,1,"Ohio, IN",5875
1177,54105,39.02775007,-81.37473928,2,0,2,"Wirt, WV",5821
1178,46102,43.33749164,-102.5555498,1,0,1,"Oglala Lakota, SD",14177
1179,1131,31.98773215,-87.30891118,34,0,34,"Wilcox, AL",10373
1180,26129,44.33481032,-84.12725175,4,0,4,"Ogemaw, MI",20997
1181,28159,33.08747908,-89.03391385,22,0,22,"Winston, MS",17955
1182,55083,45.02715345,-88.26807503,4,0,4,"Oconto, WI",37930
1183,45073,34.75225169,-83.06742317,14,0,14,"Oconee, SC",79546
1184,1133,34.15030532,-87.37325922,4,0,4,"Winston, AL",23629
1185,40107,35.46485198,-96.32639984,1,0,1,"Okfuskee, OK",11993
1186,48497,33.21570665,-97.65460265,5,0,5,"Wise, TX",69984
1187,48485,33.98842886,-98.7041034,56,0,56,"Wichita, TX",132230
1188,48499,32.78722382,-95.38236368,6,0,6,"Wood, TX",45539
1189,32033,39.44157041,-114.899966,3,0,3,"White Pine, NV",9580
1190,22069,31.72321584,-93.09816516,42,0,42,"Natchitoches, LA",38158
1191,54107,39.20967886,-81.5162836,22,0,22,"Wood, WV",83518
1192,56025,42.96180148,-106.797885,34,0,34,"Natrona, WY",79858
1193,21235,36.75700531,-84.14541217,5,0,5,"Whitley, KY",36264
1194,38065,47.11530482,-101.3406158,1,0,1,"Oliver, ND",1959
1195,21179,37.80335779,-85.4657193,13,0,13,"Nelson, KY",46233
1196,40111,35.64661916,-95.96432828,14,0,14,"Okmulgee, OK",38465
1197,53075,46.90022523,-117.5241763,12,0,12,"Whitman, WA",50104
1198,51125,37.78790447,-78.88498513,5,0,5,"Nelson, VA",14930
1199,31127,40.38514847,-95.85433992,1,0,1,"Nemaha, NE",6972
1200,20133,37.55862897,-95.30670046,2,0,2,"Neosho, KS",16007
1201,21185,38.39791089,-85.448222,19,0,19,"Oldham, KY",66799
1202,51195,36.9746148,-82.62410519,15,0,15,"Wise, VA",37383
1203,51127,37.50694406,-76.99828634,16,0,16,"New Kent, VA",23091
1204,13219,33.83749973,-83.43679568,43,0,43,"Oconee, GA",40280
1205,47133,36.34117832,-85.28989535,5,0,5,"Overton, TN",22241
1206,29143,36.59666326,-89.66070007,8,0,8,"New Madrid, MO",17076
1207,40105,36.79843529,-95.61902331,11,0,11,"Nowata, OK",10076
1208,51135,37.1435975,-78.05065922,5,0,5,"Nottoway, VA",15232
1209,51720,36.93357076,-82.62750411,0,0,0,"Norton, VA",3981
1210,51133,37.89202088,-76.41949732,4,0,4,"Northumberland, VA",12095
1211,42097,40.84785433,-76.70798222,56,0,56,"Northumberland, PA",90843
1212,51131,37.34062933,-75.87751591,4,0,4,"Northampton, VA",11710
1213,45089,33.62190129,-79.72767442,18,0,18,"Williamsburg, SC",30368
1214,56027,43.05607708,-104.4758896,1,0,1,"Niobrara, WY",2356
1215,17199,37.73033511,-88.92994027,12,0,12,"Williamson, IL",66597
1216,27107,47.32628443,-96.45620947,1,0,1,"Norman, MN",6375
1217,48493,29.1732598,-98.08693082,11,0,11,"Wilson, TX",51070
1218,51840,39.17054517,-78.17325058,21,0,21,"Winchester, VA",28078
1219,39121,39.76818851,-81.45937183,3,0,3,"Noble, OH",14424
1220,40103,36.38953329,-97.22928674,6,0,6,"Noble, OK",11131
1221,2180,64.90320724,-164.0353804,1,0,1,"Nome, AK",10004
1222,28103,33.11009499,-88.56949061,10,0,10,"Noxubee, MS",10417
1223,38105,48.34522353,-103.4793387,8,0,8,"Williams, ND",37589
1224,54067,38.29617706,-80.79759588,3,0,3,"Nicholas, WV",24496
1225,29157,37.70660776,-89.82741088,38,0,38,"Perry, MO",19136
1226,13317,33.78290391,-82.74286107,8,0,8,"Wilkes, GA",9777
1227,19191,43.29094334,-91.84422722,5,0,5,"Winneshiek, IA",19991
1228,26123,43.554374,-85.80070107,7,0,7,"Newaygo, MI",48980
1229,44005,41.5642026,-71.26569799,93,0,93,"Newport, RI",82082
1230,5101,35.91947491,-93.21612969,1,0,1,"Newton, AR",7753
1231,19189,43.37751174,-93.73407298,2,0,2,"Winnebago, IA",10354
1232,19141,43.08310673,-95.62474482,3,0,3,"O'Brien, IA",13753
1233,21181,38.33342292,-84.01889177,1,0,1,"Nicholas, KY",7269
1234,28101,32.40021118,-89.11843336,14,0,14,"Newton, MS",21018
1235,29145,36.90519407,-94.3394104,9,0,9,"Newton, MO",58236
1236,48351,30.78548982,-93.74408813,2,0,2,"Newton, TX",13595
1237,32023,38.04264256,-116.4722702,15,0,15,"Nye, NV",46523
1238,48495,31.85008651,-103.0485163,1,0,1,"Winkler, TX",8010
1239,48355,27.736286,-97.5433285,83,0,83,"Nueces, TX",362294
1240,55085,45.70677897,-89.51944105,6,0,6,"Oneida, WI",35595
1241,55141,44.45537896,-90.04158336,2,0,2,"Wood, WI",72999
1242,47185,35.92929884,-85.45591799,4,0,4,"White, TN",27345
1243,12089,30.61037141,-81.80297522,37,0,37,"Nassau, FL",88625
1244,29229,37.27029221,-92.46914488,9,0,9,"Wright, MO",18289
1245,29225,37.2813734,-92.876329,5,0,5,"Webster, MO",39592
1246,31131,40.64843556,-96.13374142,1,0,1,"Otoe, NE",16012
1247,20129,37.19141121,-101.79925190000002,1,0,1,"Morton, KS",2587
1248,35035,32.61348406,-105.7417604,3,0,3,"Otero, NM",67490
1249,8089,37.9014485,-103.7173385,5,0,5,"Otero, CO",18278
1250,48345,34.07408766,-100.779722,1,0,1,"Motley, TX",1200
1251,17139,39.64187451,-88.62099969,2,0,2,"Moultrie, IL",14501
1252,31181,40.17642643,-98.50019851,1,0,1,"Webster, NE",3487
1253,26135,44.68192279,-84.12939244,4,0,4,"Oscoda, MI",8241
1254,26133,43.98992088,-85.32566756,5,0,5,"Osceola, MI",23460
1255,18179,40.72934187,-85.22132966,4,0,4,"Wells, IN",28296
1256,27105,43.67434621,-95.75329576,2,0,2,"Nobles, MN",21629
1257,38061,48.20197971,-102.3555315,29,0,29,"Mountrail, ND",10545
1258,27099,43.67142874,-92.75234549,25,0,25,"Mower, MN",40062
1259,41049,45.41846568,-119.584546,5,0,5,"Morrow, OR",11603
1260,39117,40.52363560000001,-82.7892599,14,0,14,"Morrow, OH",35328
1261,48343,33.11304005,-94.73255695,3,0,3,"Morris, TX",12388
1262,47183,36.29896232,-88.71990865,6,0,6,"Weakley, TN",33328
1263,54099,38.14901357,-82.42287994,61,0,61,"Wayne, WV",39402
1264,51820,38.06451466,-78.90293905,6,0,6,"Waynesboro, VA",22630
1265,39115,39.62081738,-81.85308173,2,0,2,"Morgan, OH",14508
1266,47129,36.13248031,-84.64880098,6,0,6,"Morgan, TN",21403
1267,54065,39.55439028,-78.26311676,6,0,6,"Morgan, WV",17884
1268,20127,38.68827511,-96.65128437,2,0,2,"Morris, KS",5620
1269,13307,32.04066113,-84.54742852,3,0,3,"Webster, GA",2607
1270,20143,39.13237408,-97.65020313,3,0,3,"Ottawa, KS",5704
1271,5103,33.58839816,-92.87795984,5,0,5,"Ouachita, AR",23382
1272,27111,46.40846929,-95.70835255,4,0,4,"Otter Tail, MN",58746
1273,40115,36.83532655,-94.81011909,22,0,22,"Ottawa, OK",31127
1274,39123,41.53781826,-83.0940185,12,0,12,"Ottawa, OH",40525
1275,19187,42.42853483,-94.17987389,2,0,2,"Webster, IA",35904
1276,21233,37.52168356,-87.67989953,9,0,9,"Webster, KY",12942
1277,19197,42.73305373,-93.73515113,1,0,1,"Wright, IA",12562
1278,29227,40.47945588,-94.42328751,1,0,1,"Worth, MO",2013
1279,19143,43.37824276,-95.62422844,2,0,2,"Osceola, IA",5958
1280,13309,32.12009104,-82.72574721,3,0,3,"Wheeler, GA",7855
1281,51137,38.24530219,-78.01560400000002,17,0,17,"Orange, VA",37051
1282,30065,46.49684637,-108.39498,1,0,1,"Musselshell, MT",4633
1283,50017,44.00470222,-72.37640104,5,0,5,"Orange, VT",28892
1284,48361,30.11879481,-93.89412775,46,0,46,"Orange, TX",83396
1285,21239,38.04178222,-84.7417556,16,0,16,"Woodford, KY",26734
1286,48481,29.27765923,-96.22319248,28,0,28,"Wharton, TX",41556
1287,5145,35.25688493,-91.74908296,28,0,28,"White, AR",78753
1288,51193,38.11021557,-76.80213247,8,0,8,"Westmoreland, VA",18015
1289,17203,40.78579374,-89.20973757,11,0,11,"Woodford, IL",38459
1290,19193,42.38979414,-96.0459439,21,0,21,"Woodbury, IA",103107
1291,13311,34.64624278,-83.74905525,14,0,14,"White, GA",30798
1292,18181,40.74911165,-86.86492015,5,0,5,"White, IN",24102
1293,26131,46.665226200000006,-89.31390481,0,0,0,"Ontonagon, MI",5720
1294,36069,42.85145728,-77.30874425,62,0,62,"Ontario, NY",109777
1295,54103,39.6065771,-80.64016540000001,3,0,3,"Wetzel, WV",15065
1296,5147,35.18902527,-91.2439489,1,0,1,"Woodruff, AR",6320
1297,13213,34.78897608,-84.74993177,17,0,17,"Murray, GA",40096
1298,36073,43.2516977,-78.2320066,33,0,33,"Orleans, NY",40352
1299,27101,44.02216709,-95.76328482,1,0,1,"Murray, MN",8194
1300,20141,39.3503437,-98.76753828,2,0,2,"Osborne, KS",3421
1301,22123,32.78550125,-91.461201,4,0,4,"West Carroll, LA",10830
1302,29151,38.46036182,-91.8613635,4,0,4,"Osage, MO",13615
1303,20139,38.65235984,-95.72707998,4,0,4,"Osage, KS",15949
1304,50019,44.82964024,-72.24562697,8,0,8,"Orleans, VT",27037
1305,22125,30.87882871,-91.4148538,47,0,47,"West Feliciana, LA",15568
1306,39119,39.96575964,-81.94363275,8,0,8,"Muskingum, OH",86215
1307,19195,43.37750768,-93.26087602,1,0,1,"Worth, IA",7381
1308,29149,36.68710164,-91.4033755,1,0,1,"Oregon, MO",10529
1309,24047,38.21274277,-75.33200012,22,0,22,"Worcester, MD",52276
1310,40153,36.42316318,-99.26283045,1,0,1,"Woodward, OK",20211
1311,45075,33.4391073,-80.79886287,38,0,38,"Orangeburg, SC",86175
1312,20207,37.8865336,-95.74006277,4,0,4,"Woodson, KS",3138
1313,13259,32.07996777,-84.83208037,9,0,9,"Stewart, GA",6621
1314,16077,42.69254894,-112.83957420000002,2,0,2,"Power, ID",7681
1315,39127,39.73508655,-82.23804971,8,0,8,"Perry, OH",36134
1316,36097,42.39184015,-76.8773299,8,0,8,"Schuyler, NY",17807
1317,20171,38.48222076,-100.9066539,1,0,1,"Scott, KS",4823
1318,36109,42.44945765,-76.47229843,118,0,118,"Tompkins, NY",102180
1319,5127,34.85588887,-94.0632176,1,0,1,"Scott, AR",10281
1320,49045,40.44862644,-113.1295715,37,0,37,"Tooele, UT",72259
1321,37165,34.8386299,-79.4757978,9,0,9,"Scotland, NC",34823
1322,29199,40.45214695,-92.14709064,3,0,3,"Scotland, MO",4902
1323,39145,38.80270163,-82.98907345,4,0,4,"Scioto, OH",75314
1324,35057,34.64048375,-105.8508949,12,0,12,"Torrance, NM",15461
1325,13281,34.91369188,-83.74107459999998,8,0,8,"Towns, GA",12037
1326,17169,40.1571798,-90.61114163,1,0,1,"Schuyler, IL",6768
1327,28123,32.406704100000006,-89.53789439,79,0,79,"Scott, MS",28124
1328,26153,46.19235734,-86.19972234,3,0,3,"Schoolcraft, MI",8094
1329,36095,42.58831742,-74.44339029999998,20,0,20,"Schoharie, NY",30999
1330,55113,45.87931905,-91.14504927,2,0,2,"Sawyer, WI",16558
1331,31155,41.2278103,-96.63773905,6,0,6,"Saunders, NE",21578
1332,37175,35.20383864,-82.79638423,6,0,6,"Transylvania, NC",34385
1333,31153,41.11314181,-96.11156432,46,0,46,"Sarpy, NE",187196
1334,38081,46.10830372,-97.63217159,1,0,1,"Sargent, ND",3898
1335,27155,45.77298854,-96.47062949,2,0,2,"Traverse, MN",3259
1336,55121,44.30360275,-91.35893614,1,0,1,"Trempealeau, WI",29649
1337,21209,38.29622293,-84.5816631,21,0,21,"Scott, KY",57004
1338,29201,37.05588075,-89.56474493,26,0,26,"Scott, MO",38280
1339,27135,48.77501878,-95.81079919,1,0,1,"Roseau, MN",15165
1340,36099,42.78081007,-76.82497064,18,0,18,"Seneca, NY",34016
1341,18159,40.31123252,-86.05234925,10,0,10,"Tipton, IN",15148
1342,5135,36.16258158,-91.47819342,2,0,2,"Sharp, AR",17442
1343,28125,32.88149103,-90.8159538,3,0,3,"Sharkey, MS",4321
1344,47167,35.501942,-89.73694895,52,0,52,"Tipton, TN",61599
1345,31159,40.87241834,-97.139673,1,0,1,"Seward, NE",17284
1346,20175,37.19324632,-100.8507201,7,0,7,"Seward, KS",21428
1347,47155,35.78077323,-83.52244332,22,0,22,"Sevier, TN",98250
1348,5133,33.99780401,-94.2424869,8,0,8,"Sevier, AR",17007
1349,47153,35.36979721,-85.41022136,3,0,3,"Sequatchie, TN",15026
1350,28141,34.74023475,-88.23917219,2,0,2,"Tishomingo, MS",19383
1351,46121,43.19338568,-100.7195503,1,0,1,"Todd, SD",10177
1352,48449,33.21339719,-94.96797273,8,0,8,"Titus, TX",32750
1353,21219,36.8381152,-87.17878374,8,0,8,"Todd, KY",12294
1354,5131,35.19605503,-94.27162713,11,0,11,"Sebastian, AR",127827
1355,5129,35.9109364,-92.69936482,6,0,6,"Searcy, AR",7881
1356,48415,32.74613808,-100.9162664,2,0,2,"Scurry, TX",16703
1357,31157,41.85070896,-103.7080986,14,0,14,"Scotts Bluff, NE",35618
1358,51169,36.71466456,-82.60171704,3,0,3,"Scott, VA",21566
1359,47151,36.42325673,-84.50360494,10,0,10,"Scott, TN",22068
1360,27153,46.06996226,-94.89785296,2,0,2,"Todd, MN",24664
1361,13283,32.40422134,-82.56904553,1,0,1,"Treutlen, GA",6901
1362,35049,35.50708973,-105.9774716,78,0,78,"Santa Fe, NM",150358
1363,4023,31.52508998,-110.8479088,12,0,12,"Santa Cruz, AZ",46498
1364,5139,33.16887091,-92.59746952,18,0,18,"Union, AR",38682
1365,51775,37.2836193,-80.06219455,3,0,3,"Salem, VA",25301
1366,56041,41.2878183,-110.54757820000002,4,0,4,"Uinta, WY",20226
1367,8109,38.08054629,-106.282466,3,0,3,"Saguache, CO",6824
1368,49047,40.12491499,-109.5174415,6,0,6,"Uintah, UT",35734
1369,23023,43.95415864,-69.85074999,15,0,15,"Sagadahoc, ME",35856
1370,41059,45.59073056,-118.7353826,17,0,17,"Umatilla, OR",77950
1371,47171,36.10890856,-82.43709629,1,0,1,"Unicoi, TN",17883
1372,22085,31.56388699,-93.55433981,10,0,10,"Sabine, LA",23884
1373,50021,43.57723578,-73.03741676,39,0,39,"Rutland, VT",58191
1374,12125,30.04412971,-82.37497443,2,0,2,"Union, FL",15237
1375,21221,36.80767017,-87.87333656,4,0,4,"Trigg, KY",14651
1376,51167,36.93028320000001,-82.10095486,2,0,2,"Russell, VA",26586
1377,21207,36.99308373,-85.06070117,8,0,8,"Russell, KY",17923
1378,1113,32.28725256,-85.18415324,30,0,30,"Russell, AL",57961
1379,17181,37.47119609,-89.25548938,3,0,3,"Union, IL",16653
1380,55107,45.47498854,-91.1333012,3,0,3,"Rusk, WI",14178
1381,48401,32.10773545,-94.76176432,17,0,17,"Rusk, TX",54406
1382,18161,39.62550777,-84.92497066,6,0,6,"Union, IN",7054
1383,21205,38.19484205,-83.42088935,1,0,1,"Rowan, KY",24460
1384,8107,40.48596505,-106.9905548,41,0,41,"Routt, CO",25638
1385,17165,37.75332999,-88.54119706,3,0,3,"Saline, IL",23491
1386,37177,35.87147226,-76.17055253,3,0,3,"Tyrrell, NC",4016
1387,29195,39.13734288,-93.20259964,35,0,35,"Saline, MO",22761
1388,31151,40.52418865,-97.14085859,1,0,1,"Saline, NE",14224
1389,21223,38.61056487,-85.33775972,1,0,1,"Trimble, KY",8471
1390,48455,31.0879489,-95.1367187,4,0,4,"Trinity, TX",14651
1391,54093,39.11240885,-79.57053576,4,0,4,"Tucker, WV",6839
1392,46111,44.02351092,-98.0909816,3,0,3,"Sanborn, SD",2344
1393,48409,28.00880118,-97.51763891,8,0,8,"San Patricio, TX",66730
1394,35047,35.48014807,-104.8163562,2,0,2,"San Miguel, NM",27277
1395,8113,38.00450883,-108.4020725,12,0,12,"San Miguel, CO",8179
1396,53055,48.60182783,-122.96745,13,0,13,"San Juan, WA",17582
1397,49037,37.62762978,-109.80337140000002,9,0,9,"San Juan, UT",15308
1398,6109,38.02644018,-119.9525093,2,0,2,"Tuolumne, CA",54478
1399,46125,43.3109081,-97.14865776,5,0,5,"Turner, SD",8384
1400,48407,30.57933681,-95.16260304,7,0,7,"San Jacinto, TX",28859
1401,1125,33.28726072,-87.52556818,128,0,128,"Tuscaloosa, AL",209355
1402,39157,40.44214695,-81.47226262,28,0,28,"Tuscarawas, OH",91987
1403,13289,32.67435595,-83.43078662,3,0,3,"Twiggs, GA",8120
1404,48457,30.77031716,-94.37690895,4,0,4,"Tyler, TX",21672
1405,37163,34.98820368,-78.36914061,17,0,17,"Sampson, NC",63531
1406,45081,34.00795823,-81.72713237,8,0,8,"Saluda, SC",20473
1407,54095,39.46811972,-80.88772676,3,0,3,"Tyler, WV",8591
1408,55115,44.78902246,-88.76443896,6,0,6,"Shawano, WI",40899
1409,36107,42.16852837,-76.30835812,25,0,25,"Tioga, NY",48203
1410,40141,34.37288446,-98.92426619,1,0,1,"Tillman, OK",7250
1411,1119,32.59117397,-88.19916205,28,0,28,"Sumter, AL",12427
1412,20185,38.03100851,-98.71762001,1,0,1,"Stafford, KS",4156
1413,51800,36.70155394,-76.63603554,59,0,59,"Suffolk, VA",92108
1414,18153,39.08952258,-87.41414469,6,0,6,"Sullivan, IN",20669
1415,33019,43.36094111,-72.22203125,7,0,7,"Sullivan, NH",43146
1416,36089,44.4976179,-75.06550039,92,0,92,"St. Lawrence, NY",107740
1417,42113,41.44634738,-76.51246591,1,0,1,"Sullivan, PA",6066
1418,46119,44.71571812,-100.1278092,1,0,1,"Sully, SD",1391
1419,54089,37.65390597,-80.86009693,1,0,1,"Summers, WV",12573
1420,49043,40.86688146,-110.9535882,306,0,306,"Summit, UT",42145
1421,37171,36.41689489,-80.69102283,10,0,10,"Surry, NC",71783
1422,51177,38.18574462,-77.655399,60,0,60,"Spotsylvania, VA",136215
1423,51181,37.11781893,-76.88450012,3,0,3,"Surry, VA",6422
1424,22091,30.82210324,-90.71013176,14,0,14,"St. Helena, LA",10132
1425,5123,35.02201976,-90.74828138,45,0,45,"St. Francis, AR",24994
1426,55109,45.03437474,-92.45000068,10,0,10,"St. Croix, WI",90687
1427,29185,38.03699437,-93.77631447,2,0,2,"St. Clair, MO",9397
1428,51183,36.92432914,-77.25791182,10,0,10,"Sussex, VA",11159
1429,1115,33.71902176,-86.31029372,47,0,47,"St. Clair, AL",89512
1430,56037,41.65943896,-108.8827882,10,0,10,"Sweetwater, WY",42343
1431,27151,45.2829032,-95.68264092,1,0,1,"Swift, MN",9266
1432,56035,42.76558279,-109.9130922,1,0,1,"Sublette, WY",9831
1433,38093,46.97962541,-98.95637318,1,0,1,"Stutsman, ND",20704
1434,33017,43.291833,-71.02336013,69,0,69,"Strafford, NH",130633
1435,51179,38.41758738,-77.45917053,108,0,108,"Stafford, VA",152882
1436,47161,36.50235092,-87.83920548,4,0,4,"Stewart, TN",13715
1437,20189,37.1923008,-101.3118967,2,0,2,"Stevens, KS",5485
1438,30095,45.67071407,-109.3950061,1,0,1,"Stillwater, MT",9642
1439,29207,36.85571651,-89.9444155,12,0,12,"Stoddard, MO",29025
1440,37169,36.4017975,-80.23893369,10,0,10,"Stokes, NC",45591
1441,17177,42.35129217,-89.662598,9,0,9,"Stephenson, IL",44498
1442,48429,32.73553157,-98.83631615,1,0,1,"Stephens, TX",9366
1443,13257,34.55151201,-83.29405315,24,0,24,"Stephens, GA",25925
1444,27147,44.02240351,-93.22627088,9,0,9,"Steele, MN",36649
1445,27145,45.55192576,-94.61078221,7,0,7,"Stearns, MN",161075
1446,5137,35.86251946,-92.15684085,7,0,7,"Stone, AR",12506
1447,51790,38.15965544,-79.05979937,2,0,2,"Staunton, VA",24932
1448,48427,26.56150059,-98.73892358,7,0,7,"Starr, TX",64633
1449,28131,30.79187949,-89.11547539,15,0,15,"Stone, MS",18336
1450,29209,36.75000327,-93.45256475,3,0,3,"Stone, MO",31952
1451,19169,42.03621213,-93.46499005,11,0,11,"Story, IA",97117
1452,17175,41.09309773,-89.79745866,1,0,1,"Stark, IL",5342
1453,31167,41.9169835,-97.19394708,1,0,1,"Stanton, NE",5920
1454,20187,37.56304714,-101.7843534,2,0,2,"Stanton, KS",2006
1455,48437,34.53028891,-101.7349174,4,0,4,"Swisher, TX",7397
1456,18155,38.82767338,-85.03022429,12,0,12,"Switzerland, IN",10751
1457,41057,45.46248721,-123.712066,5,0,5,"Tillamook, OR",27036
1458,27141,45.44447208,-93.77617511,11,0,11,"Sherburne, MN",97238
1459,38085,46.11323337,-101.0440149,1,0,1,"Sioux, ND",4230
1460,19167,43.08221074,-96.1767568,7,0,7,"Sioux, IA",34855
1461,28127,31.91282117,-89.91716179,12,0,12,"Simpson, MS",26658
1462,13271,31.92829517,-82.93491155,11,0,11,"Telfair, GA",15860
1463,30093,45.90018933,-112.6620092,11,0,11,"Silver Bow, MT",34915
1464,27143,44.5796592,-94.23164924,1,0,1,"Sibley, MN",14865
1465,22107,32.00760749,-91.32915234,1,0,1,"Tensas, LA",4334
1466,41055,45.41501554,-120.6827834,1,0,1,"Sherman, OR",1780
1467,56033,44.79048913,-106.8862389,12,0,12,"Sheridan, WY",30485
1468,48445,33.17402785,-102.3354521,10,0,10,"Terry, TX",12337
1469,46115,44.93837606,-98.34626602,3,0,3,"Spink, SD",6376
1470,16081,43.75303583,-111.2056773,6,0,6,"Teton, ID",12142
1471,56039,43.93522482,-110.5890801,58,0,58,"Teton, WY",23464
1472,51171,38.85905135,-78.56813762,27,0,27,"Shenandoah, VA",43616
1473,48419,31.79211404,-94.14550696,46,0,46,"Shelby, TX",25274
1474,29215,37.31728859,-91.96564727,0,0,0,"Texas, MO",25398
1475,39149,40.33163494,-84.20258189,27,0,27,"Shelby, OH",48590
1476,29205,39.79742518,-92.07634971,1,0,1,"Shelby, MO",5930
1477,19165,41.6850066,-95.31015553,7,0,7,"Shelby, IA",11454
1478,17173,39.39133527,-88.80611122,4,0,4,"Shelby, IL",21634
1479,6093,41.59198861,-122.5407434,5,0,5,"Siskiyou, CA",43539
1480,51185,37.12191123,-81.56685568,4,0,4,"Tazewell, VA",40595
1481,53059,46.02408726,-121.9164403,3,0,3,"Skamania, WA",12083
1482,38087,46.44737738,-103.4601547,3,0,3,"Slope, ND",750
1483,21215,38.03223971,-85.32749335,9,0,9,"Spencer, KY",19351
1484,18147,38.01519732,-87.0079644,4,0,4,"Spencer, IN",20277
1485,28135,33.95339918,-90.1729398,6,0,6,"Tallahatchie, MS",13809
1486,2240,63.87692095,-143.2127643,1,0,1,"Southeast Fairbanks, AK",6893
1487,51175,36.72231125,-77.10642712,6,0,6,"Southampton, VA",17631
1488,35055,36.58006022,-105.6310198,15,0,15,"Taos, NM",32723
1489,42111,39.97172723,-79.02699593,14,0,14,"Somerset, PA",73447
1490,28137,34.65133709,-89.94485778,26,0,26,"Tate, MS",28321
1491,24039,38.1163542,-75.75118623,5,0,5,"Somerset, MD",25616
1492,23025,45.51229767,-69.95995554,13,0,13,"Somerset, ME",50484
1493,13267,32.04785085,-82.05539188,5,0,5,"Tattnall, GA",25286
1494,35053,34.00715494,-106.9298354,16,0,16,"Socorro, NM",16637
1495,12123,30.04848048,-83.60445406,1,0,1,"Taylor, FL",21569
1496,51173,36.84455636,-81.53344948,11,0,11,"Smyth, VA",30104
1497,47159,36.25359775,-85.95411046,10,0,10,"Smith, TN",20157
1498,19173,40.73710579,-94.69778563,1,0,1,"Taylor, IA",6121
1499,21217,37.3677562,-85.3329931,4,0,4,"Taylor, KY",25769
1500,20183,39.78516566,-98.78566062,1,0,1,"Smith, KS",3583
1501,54091,39.33602617,-80.0421439,4,0,4,"Taylor, WV",16695
1502,39141,39.33705391,-83.06000914,21,0,21,"Ross, OH",76666
1503,26143,44.33473082,-84.61067651,9,0,9,"Roscommon, MI",24019
1504,44009,41.45961631,-71.61435303,152,0,152,"Washington, RI",125577
1505,37185,36.39728256,-78.10652228,3,0,3,"Warren, NC",19731
1506,55097,44.47558711,-89.50152965,4,0,4,"Portage, WI",70772
1507,29219,38.76529479,-91.16124662,17,0,17,"Warren, MO",35649
1508,51735,37.14259351,-76.35798148,6,0,6,"Poquoson, VA",12271
1509,5115,35.44871474,-93.03212219,31,0,31,"Pope, AR",64072
1510,36113,43.56173026,-73.8433699,77,0,77,"Warren, NY",63944
1511,30073,48.22773388,-112.2252703,1,0,1,"Pondera, MT",5911
1512,55095,45.46130348,-92.44182875,3,0,3,"Polk, WI",43783
1513,48373,30.79472531,-94.8276624,11,0,11,"Polk, TX",51353
1514,47139,35.12245443,-84.52075859,5,0,5,"Polk, TN",16832
1515,37149,35.27820615,-82.16812354,9,0,9,"Polk, NC",20724
1516,21227,36.99903045,-86.42672751,52,0,52,"Warren, KY",132896
1517,31143,41.18813488,-97.56630712,2,0,2,"Polk, NE",5213
1518,29167,37.6162296,-93.39828174,1,0,1,"Polk, MO",32149
1519,27119,47.77372465,-96.40134647,1,0,1,"Polk, MN",31364
1520,13233,34.00267074,-85.18677781,27,0,27,"Polk, GA",42613
1521,42123,41.81304978,-79.26969577,1,0,1,"Warren, PA",39191
1522,5113,34.48254879,-94.22728802,6,0,6,"Polk, AR",19964
1523,47177,35.6728299,-85.77969117,4,0,4,"Warren, TN",41277
1524,5111,35.57433534,-90.66268713,7,0,7,"Poinsett, AR",23528
1525,51187,38.90847745,-78.20280433,20,0,20,"Warren, VA",40164
1526,51740,36.85914825,-76.35971629,59,0,59,"Portsmouth, VA",94398
1527,18129,38.02097333,-87.86480429,6,0,6,"Posey, IN",25427
1528,35041,34.02097406,-103.4799493,1,0,1,"Roosevelt, NM",18500
1529,26141,45.34018577,-83.91498656,2,0,2,"Presque Isle, MI",12592
1530,28147,31.14971548,-90.10446654,22,0,22,"Walthall, MS",14286
1531,8099,37.95544985,-102.3926052,1,0,1,"Prowers, CO",12172
1532,12131,30.64204028,-86.16935664,29,0,29,"Walton, FL",74071
1533,2198,55.76261984,-133.0511621,2,0,2,"Prince of Wales-Hyder, AK",6203
1534,46129,45.43019636,-100.0307514,5,0,5,"Walworth, SD",5435
1535,51149,37.18497668,-77.22922187,27,0,27,"Prince George, VA",38353
1536,51147,37.22554789,-78.43597949,15,0,15,"Prince Edward, VA",22802
1537,55099,45.68051754,-90.3609888,1,0,1,"Price, WI",13351
1538,54077,39.46770987,-79.66712803,6,0,6,"Preston, WV",33432
1539,19179,41.03064984,-92.40954728,7,0,7,"Wapello, IA",34969
1540,20149,39.37925655,-96.34564657,5,0,5,"Pottawatomie, KS",24383
1541,28117,34.61810501,-88.51986294,15,0,15,"Prentiss, MS",25126
1542,13301,33.41146451,-82.67795848,8,0,8,"Warren, GA",5254
1543,20151,37.64780729,-98.73922153,1,0,1,"Pratt, KS",9164
1544,5117,34.83624419,-91.55162157,2,0,2,"Prairie, AR",8062
1545,51145,37.55016038,-77.91267882,5,0,5,"Powhatan, VA",29652
1546,17187,40.84925021,-90.6147432,2,0,2,"Warren, IL",16844
1547,21197,37.83218794,-83.82553961,1,0,1,"Powell, KY",12359
1548,42105,41.74471626,-77.89559864,4,0,4,"Potter, PA",16526
1549,19181,41.33559454,-93.56007641,16,0,16,"Warren, IA",51466
1550,19149,42.737633,-96.21366621,4,0,4,"Plymouth, IA",25177
1551,49051,40.33110236,-111.1691419,102,0,102,"Wasatch, UT",34091
1552,41065,45.16292781,-121.1670954,10,0,10,"Wasco, OR",26682
1553,39129,39.64170392,-83.0243386,172,0,172,"Pickaway, OH",58457
1554,17149,39.62265059,-90.8877017,1,0,1,"Pike, IL",15561
1555,31177,41.52815707,-96.22019892,22,0,22,"Washington, NE",20729
1556,5109,34.16250414,-93.65789349,2,0,2,"Pike, AR",10718
1557,1109,31.80396383,-85.9408295,24,0,24,"Pike, AL",33114
1558,55093,44.71850291,-92.4224416,7,0,7,"Pierce, WI",42754
1559,38069,48.24977025,-99.96407787,2,0,2,"Pierce, ND",3975
1560,31139,42.26434853,-97.60122773,1,0,1,"Pierce, NE",7148
1561,45077,34.88807695,-82.72791551,34,0,34,"Pickens, SC",126884
1562,1107,33.28094866,-88.08818103,26,0,26,"Pickens, AL",19930
1563,17147,40.01360584,-88.59319339,6,0,6,"Piatt, IL",16344
1564,27161,44.02211116,-93.58720034,3,0,3,"Waseca, MN",18612
1565,20147,39.78465501,-99.34668865,1,0,1,"Phillips, KS",5234
1566,8095,40.59414277,-102.3577703,4,0,4,"Phillips, CO",4265
1567,31137,40.51156033,-99.41461667,1,0,1,"Phelps, NE",9034
1568,29161,37.87736118,-91.79351727,1,0,1,"Phelps, MO",44573
1569,29159,38.72798918,-93.28471706,3,0,3,"Pettis, MO",42339
1570,51730,37.20530399,-77.39368102,19,0,19,"Petersburg, VA",31346
1571,2195,57.13978948,-132.9540995,2,0,2,"Petersburg, AK",3266
1572,37145,36.38989032,-78.97217358,13,0,13,"Person, NC",39490
1573,47135,35.63708728,-87.86139634,4,0,4,"Perry, TN",8076
1574,29221,37.96130078,-90.87948158,1,0,1,"Washington, MO",24730
1575,18125,38.40112197,-87.23574907,1,0,1,"Pike, IN",12389
1576,23029,45.01607142,-67.62813524,2,0,2,"Washington, ME",31379
1577,21229,37.75599461,-85.17407732,3,0,3,"Washington, KY",12095
1578,6063,40.00355989,-120.8395236,4,0,4,"Plumas, CA",18807
1579,54073,39.37091679,-81.16771771,1,0,1,"Pleasants, WV",7460
1580,56031,42.13299116,-104.966331,0,0,0,"Platte, WY",8393
1581,31141,41.57246836,-97.52144359,6,0,6,"Platte, NE",33470
1582,56043,43.90451606,-107.68018700000002,5,0,5,"Washakie, WY",7805
1583,29165,39.38154439,-94.77068479,26,0,26,"Platte, MO",104418
1584,51143,36.81980341,-79.39731264,4,0,4,"Pittsylvania, VA",60354
1585,5143,35.976844,-94.21800746,44,0,44,"Washington, AR",239187
1586,8121,39.97015535,-103.202587,5,0,5,"Washington, CO",4908
1587,12133,30.61359259,-85.66002461,5,0,5,"Washington, FL",25473
1588,27117,44.02301619,-96.25841142,1,0,1,"Pipestone, MN",9126
1589,13303,32.96711864,-82.79357039,22,0,22,"Washington, GA",20374
1590,16087,44.45275475,-116.7847688,1,0,1,"Washington, ID",10194
1591,27115,46.12105238,-92.74070188,6,0,6,"Pine, MN",29579
1592,4021,32.90525627,-111.3449483,182,0,182,"Pinal, AZ",462789
1593,17189,38.35309213,-89.40982703,3,0,3,"Washington, IL",13887
1594,18175,38.60219804,-86.1049363,27,0,27,"Washington, IN",28036
1595,39131,39.07634001,-83.06769584,1,0,1,"Pike, OH",27772
1596,29163,39.34310674,-91.16980779,6,0,6,"Pike, MO",18302
1597,38099,48.36876964,-97.72574783,3,0,3,"Walsh, ND",10641
1598,41063,45.57894064,-117.18353799999998,1,0,1,"Wallowa, OR",7208
1599,48473,30.01058447,-95.99011759,20,0,20,"Waller, TX",55246
1600,35061,34.71669834,-106.8103733,21,0,21,"Valencia, NM",76688
1601,51770,37.27791025,-79.96189766,22,0,22,"Roanoke City, VA",99143
1602,51161,37.26865804,-80.06396753,17,0,17,"Roanoke, VA",94186
1603,54087,38.71622686,-81.35243568,2,0,2,"Roane, WV",13688
1604,47145,35.84923189,-84.52458689,5,0,5,"Roane, TN",53382
1605,29181,36.65460667,-90.85990261,3,0,3,"Ripley, MO",13288
1606,8105,37.5836865,-106.3847838,5,0,5,"Rio Grande, CO",11267
1607,48465,29.89149232,-101.1525205,12,0,12,"Val Verde, TX",49025
1608,8103,39.97913541,-108.2179009,1,0,1,"Rio Blanco, CO",6324
1609,35039,36.51072137,-106.6931674,10,0,10,"Rio Arriba, NM",38921
1610,16085,44.76728382,-115.5676773,2,0,2,"Valley, ID",11392
1611,47175,35.69864497,-85.45221699,1,0,1,"Van Buren, TN",5872
1612,20161,39.28935726,-96.73420026,25,0,25,"Riley, KS",74232
1613,51760,37.53255773,-77.47966921,177,0,177,"Richmond City, VA",230436
1614,51159,37.937575,-76.72920628,7,0,7,"Richmond, VA",9023
1615,19177,40.75326764,-91.95017958,8,0,8,"Van Buren, IA",7044
1616,55103,43.3762778,-90.43012729,7,0,7,"Richland, WI",17252
1617,38077,46.26440649,-96.94852979,3,0,3,"Richland, ND",16177
1618,30083,47.78668011,-104.5610786,3,0,3,"Richland, MT",10803
1619,22083,32.41391005,-91.76634876,21,0,21,"Richland, LA",20122
1620,17159,38.71240969,-88.08475366,1,0,1,"Richland, IL",15513
1621,46109,45.62975048,-96.94672673,4,0,4,"Roberts, SD",10394
1622,47147,36.52454807,-86.87346725,88,0,88,"Robertson, TN",71813
1623,48463,29.35739637,-99.76229172,6,0,6,"Uvalde, TX",26741
1624,48395,31.02539637,-96.51272246,2,0,2,"Robertson, TX",17074
1625,19175,41.0277278,-94.24234847,1,0,1,"Union, IA",12241
1626,30085,48.29607488,-105.0079268,4,0,4,"Roosevelt, MT",11004
1627,21225,37.66166713,-87.94300009,5,0,5,"Union, KY",14381
1628,20163,39.35022773,-99.32484567,2,0,2,"Rooks, KS",4920
1629,38079,48.77245354,-99.84097493,1,0,1,"Rolette, ND",14176
1630,39159,40.30016061,-83.37239023,11,0,11,"Union, OH",58988
1631,41061,45.30915495,-118.0068979,4,0,4,"Union, OR",26835
1632,48397,32.89779518,-96.40771592,39,0,39,"Rockwall, TX",104915
1633,42119,40.96188846,-77.05996014,23,0,23,"Union, PA",44923
1634,51165,38.51006137,-78.87260325,67,0,67,"Rockingham, VA",81948
1635,45087,34.68835752,-81.61730349,23,0,23,"Union, SC",27316
1636,46127,42.83112163,-96.6557828,4,0,4,"Union, SD",15932
1637,47173,36.28590426,-83.83651902,3,0,3,"Union, TN",19972
1638,48459,32.73706798,-94.93999853,9,0,9,"Upshur, TX",41753
1639,54097,38.89285061,-80.23689136,3,0,3,"Upshur, WV",24176
1640,21203,37.36642393,-84.31176452,9,0,9,"Rockcastle, KY",16695
1641,51163,37.81204314,-79.44605905,3,0,3,"Rockbridge, VA",22573
1642,27133,43.67482683,-96.25296832,2,0,2,"Rock, MN",9315
1643,37155,34.64244496,-79.10250529999998,11,0,11,"Robeson, NC",130625
1644,27131,44.3543376,-93.29658715,5,0,5,"Rice, MN",66972
1645,47143,35.60536161,-84.93076643,0,0,0,"Rhea, TN",33167
1646,17153,37.22631423,-89.13085001,5,0,5,"Pulaski, IL",5335
1647,35037,35.10403332,-103.5481727,1,0,1,"Quay, NM",8253
1648,18169,40.84704239,-85.79328272,7,0,7,"Wabash, IN",30996
1649,54081,37.76936795,-81.2456041,6,0,6,"Raleigh, WV",73361
1650,27157,44.28424356,-92.23121312,7,0,7,"Wabasha, MN",21627
1651,48379,32.87109387,-95.79232691,2,0,2,"Rains, TX",12514
1652,51750,37.12222899,-80.56027320000003,1,0,1,"Radford, VA",18249
1653,13241,34.88389445,-83.40304637,7,0,7,"Rabun, GA",17137
1654,28119,34.25157572,-90.28908,13,0,13,"Quitman, MS",6792
1655,20197,38.95471985,-96.20350509,1,0,1,"Wabaunsee, KS",6931
1656,53069,46.29180039999999,-123.4250831,2,0,2,"Wahkiakum, WA",4488
1657,54079,38.50782345,-81.9082131,13,0,13,"Putnam, WV",56450
1658,39161,40.8554138,-84.59111700000003,2,0,2,"Van Wert, OH",28275
1659,47141,36.14005459,-85.50646123,92,0,92,"Putnam, TN",80245
1660,39137,41.02094889,-84.1336111,4,0,4,"Putnam, OH",33861
1661,1127,33.80270512,-87.30027177,84,0,84,"Walker, AL",63521
1662,13295,34.73376362,-85.30165174,13,0,13,"Walker, GA",69761
1663,48471,30.73872995,-95.57440968,38,0,38,"Walker, TX",72971
1664,13237,33.32056115,-83.37552891,12,0,12,"Putnam, GA",22119
1665,53071,46.23040051,-118.4775539,23,0,23,"Walla Walla, WA",60760
1666,51155,37.06474963,-80.71229738,4,0,4,"Pulaski, VA",34027
1667,18131,41.04166107,-86.69890683,1,0,1,"Pulaski, IN",12353
1668,29173,39.52817427,-91.51838643,1,0,1,"Ralls, MO",10309
1669,17185,38.44272901,-87.84922065,1,0,1,"Wabash, IL",11520
1670,38071,48.26886249,-98.72223879,3,0,3,"Ramsey, ND",11519
1671,55125,46.05467334,-89.51719204,4,0,4,"Vilas, WI",22195
1672,29179,37.36085952,-90.97009925,2,0,2,"Reynolds, MO",6270
1673,20157,39.82799632,-97.65036709,4,0,4,"Republic, KS",4636
1674,27129,44.72836381,-94.94553734,3,0,3,"Renville, MN",14548
1675,20155,37.95230263,-98.08607292,14,0,14,"Reno, KS",61998
1676,48389,31.32323325,-103.6903896,2,0,2,"Reeves, TX",15976
1677,37181,36.36880673,-78.40670845,22,0,22,"Vance, NC",44535
1678,27127,44.40555844,-95.25207021,1,0,1,"Redwood, MN",15170
1679,42121,41.40323442,-79.75845449,6,0,6,"Venango, PA",50668
1680,27125,47.87197525,-96.09561104,1,0,1,"Red Lake, MN",4055
1681,29177,39.3537468,-93.98905745,7,0,7,"Ray, MO",23018
1682,17183,40.18417171,-87.73384359,8,0,8,"Vermilion, IL",75758
1683,30081,46.08520862,-114.11891640000002,5,0,5,"Ravalli, MT",43806
1684,51157,38.68295619,-78.15826963,1,0,1,"Rappahannock, VA",7370
1685,18165,39.8523352,-87.46160542,4,0,4,"Vermillion, IN",15498
1686,29217,37.8457799,-94.34127305,3,0,3,"Vernon, MO",20563
1687,54083,38.769899,-79.87919615,4,0,4,"Randolph, WV",28695
1688,29175,39.44007257,-92.4971374,8,0,8,"Randolph, MO",24748
1689,17157,38.05095369,-89.82512254,46,0,46,"Randolph, IL",31782
1690,5121,36.3415714,-91.02455531,9,0,9,"Randolph, AR",17958
1691,18107,40.04034823,-86.89335024,25,0,25,"Montgomery, IN",38338
1692,45001,34.22333378,-82.46170658,10,0,10,"Abbeville, SC",24527
1693,13209,32.17201038,-82.53527476,2,0,2,"Montgomery, GA",9172
1694,51580,37.7824656,-79.98631446,1,0,1,"Covington, VA",5538
1695,55023,43.23870316,-90.93073686,3,0,3,"Crawford, WI",16131
1696,42039,41.68447709,-80.10760592,16,0,16,"Crawford, PA",84629
1697,39033,40.85065156,-82.91989099,23,0,23,"Crawford, OH",41494
1698,29055,37.97663738,-91.30528104,5,0,5,"Crawford, MO",23920
1699,18025,38.28814402,-86.44518825,12,0,12,"Crawford, IN",10577
1700,17033,39.0032229,-87.75954624,4,0,4,"Crawford, IL",18667
1701,13079,32.71391813,-83.98061238,10,0,10,"Crawford, GA",12404
1702,5033,35.58928601,-94.2446814,4,0,4,"Crawford, AR",63257
1703,48103,31.43052248,-102.5143314,2,0,2,"Crane, TX",4797
1704,5031,35.83018283,-90.63235729,38,0,38,"Craighead, AR",110332
1705,51045,37.48133648,-80.21072274,2,0,2,"Craig, VA",5131
1706,40035,36.76268118,-95.20916602,8,0,8,"Craig, OK",14142
1707,53015,46.19074721,-122.6782231,26,0,26,"Cowlitz, WA",110593
1708,28031,31.63225413,-89.55389939,19,0,19,"Covington, MS",18636
1709,56009,42.97272268,-105.5081848,8,0,8,"Converse, WY",13822
1710,1039,31.2477854,-86.45050893,17,0,17,"Covington, AL",37049
1711,27033,44.00715262,-95.18138802,6,0,6,"Cottonwood, MN",11196
1712,40033,34.28845626,-98.37053567,5,0,5,"Cotton, OK",5666
1713,8023,37.27732493,-105.4276548,3,0,3,"Costilla, CO",3887
1714,39031,40.30096166,-81.91729018,16,0,16,"Coshocton, OH",36600
1715,48099,31.39078397,-97.79936155,60,0,60,"Coryell, TX",75951
1716,36023,42.59509207,-76.07048931,23,0,23,"Cortland, NY",47581
1717,46031,45.70889983,-101.1970473,1,0,1,"Corson, SD",4086
1718,28029,31.86977774,-90.44565118,35,0,35,"Copiah, MS",28065
1719,41011,43.17406868,-124.0594514,1,0,1,"Coos, OR",64487
1720,33007,44.69063265,-71.30633239,2,0,2,"Coos, NH",31563
1721,29053,38.844478,-92.80896081,4,0,4,"Cooper, MO",17709
1722,48097,33.63979567,-97.21240912,2,0,2,"Cooke, TX",41257
1723,1041,31.72941803,-86.31593104,3,0,3,"Crenshaw, AL",13772
1724,21055,37.35839237,-88.08826090000002,3,0,3,"Crittenden, KY",8806
1725,47033,35.81830662,-89.14916269,0,0,0,"Crockett, TN",14230
1726,41013,44.14230227,-120.356297,1,0,1,"Crook, OR",24404
1727,17039,40.17514519,-88.90959682,1,0,1,"De Witt, IL",15638
1728,31047,40.87028216,-99.8201461,18,0,18,"Dawson, NE",23595
1729,46035,43.67490933,-98.14458906,3,0,3,"Davison, SD",19775
1730,45031,34.33358335,-79.96027485,44,0,44,"Darlington, SC",66618
1731,51590,36.58022376,-79.40395668,22,0,22,"Danville, VA",40044
1732,29059,37.6811355,-93.02127031,2,0,2,"Dallas, MO",16878
1733,19049,41.68560356,-94.04127625,38,0,38,"Dallas, IA",93453
1734,5039,33.97042763,-92.65167437,1,0,1,"Dallas, AR",7009
1735,48111,36.27787176,-102.6020725,2,0,2,"Dallam, TX",7287
1736,1045,31.43037123,-85.61095742,12,0,12,"Dale, AL",49172
1737,31043,42.39040144,-96.56656425,2,0,2,"Dakota, NE",20026
1738,40039,35.63853802,-99.00170785,7,0,7,"Custer, OK",29003
1739,31041,41.39374521,-99.72805369,19,0,19,"Custer, NE",10777
1740,16037,44.24186819,-114.2855494,2,0,2,"Custer, ID",4315
1741,8027,38.10883162,-105.3683478,2,0,2,"Custer, CO",5068
1742,41015,42.45911325,-124.157282,3,0,3,"Curry, OR",22925
1743,35009,34.57421077,-103.3468876,10,0,10,"Curry, NM",48954
1744,37053,36.36123664,-75.95876401,3,0,3,"Currituck, NC",27763
1745,31039,41.91637624,-96.78730772,2,0,2,"Cuming, NE",8846
1746,51049,37.51328851,-78.24398086,8,0,8,"Cumberland, VA",9932
1747,47035,35.95271721,-84.99840585,51,0,51,"Cumberland, TN",60520
1748,21057,36.78926125,-85.39050034,2,0,2,"Cumberland, KY",6614
1749,17035,39.27432424,-88.2401158,2,0,2,"Cumberland, IL",10766
1750,51047,38.48199985,-77.95630870000002,25,0,25,"Culpeper, VA",52605
1751,27035,46.48096553,-94.06755609,17,0,17,"Crow Wing, MN",65055
1752,5037,35.29631396,-90.77185818,7,0,7,"Cross, AR",16419
1753,56011,44.58855102,-104.5697705,4,0,4,"Crook, WY",7584
1754,13075,31.16068491,-83.42947229,8,0,8,"Cook, GA",17270
1755,1035,31.43401703,-86.99320044,5,0,5,"Conecuh, AL",12067
1756,29063,39.89201062,-94.40476508,3,0,3,"DeKalb, MO",12547
1757,51043,39.11271747,-77.99199425,6,0,6,"Clarke, VA",14619
1758,48077,33.78686685,-98.20771198,3,0,3,"Clay, TX",10471
1759,47027,36.55151008,-85.53930419,4,0,4,"Clay, TN",7615
1760,46027,42.91296147,-96.97656917,5,0,5,"Clay, SD",14070
1761,37043,35.05704275,-83.74353633,4,0,4,"Clay, NC",11231
1762,31035,40.52439441,-98.05126296,2,0,2,"Clay, NE",6203
1763,28025,33.65358105,-88.77784255,21,0,21,"Clay, MS",19316
1764,20027,39.34948772,-97.16518128,1,0,1,"Clay, KS",8002
1765,19041,43.08247182,-95.15096481,2,0,2,"Clay, IA",16016
1766,18021,39.39561833,-87.11723506,13,0,13,"Clay, IN",26225
1767,17025,38.75388572,-88.48914513,1,0,1,"Clay, IL",13184
1768,5021,36.36826212,-90.4148172,1,0,1,"Clay, AR",14551
1769,1027,33.26984193,-85.85836077,14,0,14,"Clay, AL",13235
1770,41007,45.99712889,-123.660711,6,0,6,"Clatsop, OR",40224
1771,19039,41.02868181,-93.78499767,2,0,2,"Clarke, IA",9395
1772,48095,31.32635934,-99.86473038,1,0,1,"Concho, TX",2726
1773,1025,31.68099859,-87.83548597,21,0,21,"Clarke, AL",23622
1774,55019,44.73483377,-90.61207486,9,0,9,"Clark, WI",34774
1775,46025,44.85834507,-97.72925109,1,0,1,"Clark, SD",3736
1776,39023,39.91592258,-83.78498252,21,0,21,"Clark, OH",134083
1777,29045,40.41040752,-91.73661677,1,0,1,"Clark, MO",6797
1778,21049,37.9689263,-84.14615986,18,0,18,"Clark, KY",36263
1779,17023,39.33425789,-87.78705622,4,0,4,"Clark, IL",15441
1780,5019,34.04613432,-93.17484713,27,0,27,"Clark, AR",22320
1781,42031,41.19265812,-79.42413524,16,0,16,"Clarion, PA",38438
1782,53009,48.04754642,-123.9226319,14,0,14,"Clallam, WA",77331
1783,47025,36.48319149,-83.65947309,5,0,5,"Claiborne, TN",31959
1784,28021,31.97061673,-90.90702196,8,0,8,"Claiborne, MS",8988
1785,29043,36.9711783,-93.18537118,19,0,19,"Christian, MO",88595
1786,8019,39.68864463,-105.6463118,11,0,11,"Clear Creek, CO",9700
1787,42033,41.00110782,-78.47592663,9,0,9,"Clearfield, PA",79255
1788,27029,47.57992111,-95.37790562,3,0,3,"Clearwater, MN",8818
1789,1029,33.67679204,-85.52005899,12,0,12,"Cleburne, AL",14910
1790,48093,31.94854689,-98.55876441,3,0,3,"Comanche, TX",13635
1791,40031,34.65973764,-98.47195055,52,0,52,"Comanche, OK",120749
1792,6011,39.17881957,-122.2331726,3,0,3,"Colusa, CA",21547
1793,53013,46.29442881,-117.9051983,1,0,1,"Columbia, WA",3985
1794,41009,45.94464254,-123.0890898,14,0,14,"Columbia, OR",52354
1795,13073,33.54534185,-82.263524,78,0,78,"Columbia, GA",156714
1796,12023,30.22509788,-82.62160164,34,0,34,"Columbia, FL",71686
1797,5027,33.21230701,-93.22642793,4,0,4,"Columbia, AR",23457
1798,48089,29.622098,-96.5273805,7,0,7,"Colorado, TX",21493
1799,51570,37.26420587,-77.39609676,17,0,17,"Colonial Heights, VA",17370
1800,35007,36.60569702,-104.64726740000002,2,0,2,"Colfax, NM",11941
1801,31037,41.57486951,-97.0868542,4,0,4,"Colfax, NE",10709
1802,17029,39.51949084,-88.22358557,9,0,9,"Coles, IL",50621
1803,47031,35.49090731,-86.07311784,12,0,12,"Coffee, TN",56520
1804,1031,31.39932826,-85.98901039,40,0,40,"Coffee, AL",52342
1805,46029,44.97788119,-97.18827677,13,0,13,"Codington, SD",28009
1806,47029,35.9278914,-83.11828725,5,0,5,"Cocke, TN",36004
1807,4003,31.87934684,-109.7516088,15,0,15,"Cochise, AZ",125922
1808,20029,39.48028352,-97.64925343,3,0,3,"Cloud, KS",8786
1809,42035,41.23255967,-77.63785995,8,0,8,"Clinton, PA",38632
1810,39027,39.41485808,-83.80852286,23,0,23,"Clinton, OH",41968
1811,29049,39.6013098,-94.40465394,11,0,11,"Clinton, MO",20387
1812,21053,36.72581156,-85.13377529,2,0,2,"Clinton, KY",10218
1813,19045,41.89981633,-90.53275096,38,0,38,"Clinton, IA",46429
1814,17027,38.60704876,-89.42385254,39,0,39,"Clinton, IL",37562
1815,13065,30.91395822,-82.70432472,7,0,7,"Clinch, GA",6618
1816,5025,33.89723187,-92.18537045,8,0,8,"Cleveland, AR",7956
1817,1049,34.45946862,-85.80782906,29,0,29,"DeKalb, AL",71513
1818,48123,29.08101855,-97.35681170000001,10,0,10,"DeWitt, TX",20160
1819,40023,34.02807439,-95.54771129,3,0,3,"Choctaw, OK",14672
1820,39047,39.56021306,-83.4562016,12,0,12,"Fayette, OH",28525
1821,20057,37.69200114,-99.88825298,32,0,32,"Ford, KS",33619
1822,51065,37.84157909,-78.27715475,62,0,62,"Fluvanna, VA",27270
1823,51063,36.9302126,-80.36738849,1,0,1,"Floyd, VA",15749
1824,48153,34.07227468,-101.3031546,2,0,2,"Floyd, TX",5712
1825,21071,37.56213922,-82.74750924,0,0,0,"Floyd, KY",35589
1826,55037,45.84963535,-88.39804137,2,0,2,"Florence, WI",4295
1827,21069,38.36758311,-83.69657514,2,0,2,"Fleming, KY",14581
1828,27045,43.67394126,-92.08980382,10,0,10,"Fillmore, MN",21067
1829,53019,48.471143100000006,-118.5154041,1,0,1,"Ferry, WA",7627
1830,47049,36.38128818,-84.92870012,3,0,3,"Fentress, TN",18523
1831,54019,38.02974928,-81.08286634,2,0,2,"Fayette, WV",42406
1832,48149,29.87788372,-96.92076062,12,0,12,"Fayette, TX",25346
1833,47047,35.19615831,-89.41399032,37,0,37,"Fayette, TN",41133
1834,19065,42.86271799,-91.8441231,5,0,5,"Fayette, IA",19650
1835,50009,44.72736416,-71.73579864,1,0,1,"Essex, VT",6163
1836,1057,33.72076938,-87.73886638,4,0,4,"Fayette, AL",16302
1837,51061,38.73564842,-77.80647472,29,0,29,"Fauquier, VA",71222
1838,46049,45.07082625,-99.14535601,1,0,1,"Faulk, SD",2299
1839,27043,43.67381499,-93.94787458,4,0,4,"Faribault, MN",13653
1840,48147,33.59564294,-96.10751083,5,0,5,"Fannin, TX",35514
1841,13111,34.86430205,-84.316964,14,0,14,"Fannin, GA",26188
1842,51610,38.88485255,-77.17560759,0,0,0,"Falls Church, VA",14617
1843,48145,31.25350609,-96.93630086,1,0,1,"Falls, TX",17297
1844,46047,43.23929297,-103.5275691,1,0,1,"Fall River, SD",6713
1845,45039,34.39287073,-81.1195624,24,0,24,"Fairfield, SC",22347
1846,51600,38.85157547,-77.29779640000002,0,0,0,"Fairfax City, VA",24019
1847,13109,32.15328841,-81.8870105,2,0,2,"Evans, GA",10654
1848,22039,30.72985248,-92.39915924,40,0,40,"Evangeline, LA",33395
1849,42053,41.51095103,-79.23229292,5,0,5,"Forest, PA",7247
1850,38031,47.4571084,-98.88279923,1,0,1,"Foster, ND",3210
1851,5047,35.51202821,-93.89299569,1,0,1,"Franklin, AR",17715
1852,12037,29.83791238,-84.82731662,2,0,2,"Franklin, FL",12125
1853,12039,30.57796289,-84.61915825,40,0,40,"Gadsden, FL",45660
1854,42057,39.92913544,-78.11163677,2,0,2,"Fulton, PA",14530
1855,39051,41.60213491,-84.12571393,8,0,8,"Fulton, OH",42126
1856,36035,43.11363907,-74.41798804,24,0,24,"Fulton, NY",53383
1857,18049,41.0469907,-86.26252745,3,0,3,"Fulton, IN",19974
1858,17057,40.47289135,-90.20862357,1,0,1,"Fulton, IL",34340
1859,48163,28.86751206,-99.10804207,1,0,1,"Frio, TX",20306
1860,56013,43.04183996,-108.6296893,42,0,42,"Fremont, WY",39261
1861,16043,44.22800938,-111.4809943,2,0,2,"Fremont, ID",13099
1862,8043,38.47362326,-105.4399667,8,0,8,"Fremont, CO",47839
1863,48161,31.70422788,-96.15072516,1,0,1,"Freestone, TX",19717
1864,27047,43.67385583,-93.34884422,27,0,27,"Freeborn, MN",30281
1865,51630,38.2977863,-77.4922454,15,0,15,"Fredericksburg, VA",29036
1866,51069,39.20172582,-78.25974949,73,0,73,"Frederick, VA",89313
1867,51620,36.6831435,-76.93859681,7,0,7,"Franklin City, VA",7967
1868,51067,36.99536167,-79.88023649,15,0,15,"Franklin, VA",56042
1869,48159,33.17653242,-95.21917243,1,0,1,"Franklin, TX",10725
1870,42055,39.92956518,-77.72157791,78,0,78,"Franklin, PA",155027
1871,36033,44.59040891,-74.29926032,13,0,13,"Franklin, NY",50022
1872,31061,40.17636348,-98.95299073,3,0,3,"Franklin, NE",2979
1873,28037,31.47786634,-90.89672989,10,0,10,"Franklin, MS",7713
1874,23007,44.97330019,-70.44381045,9,0,9,"Franklin, ME",30199
1875,21073,38.2379395,-84.87962551,11,0,11,"Franklin, KY",50991
1876,20059,38.56443815,-95.28644341,12,0,12,"Franklin, KS",25544
1877,19069,42.73270384,-93.26256925,1,0,1,"Franklin, IA",10070
1878,17055,37.99189086,-88.92567818,4,0,4,"Franklin, IL",38469
1879,13119,34.37525597,-83.23159927,7,0,7,"Franklin, GA",23349
1880,51057,37.93357639,-76.94230311,0,0,0,"Essex, VA",10953
1881,36031,44.11630765,-73.77297842,12,0,12,"Essex, NY",36885
1882,48117,34.96522957,-102.6054267,11,0,11,"Deaf Smith, TX",18546
1883,51051,37.12560977,-82.35124171,0,0,0,"Dickenson, VA",14318
1884,48129,34.96517499,-100.8140093,22,0,22,"Donley, TX",3278
1885,20043,39.79067154,-95.14056866,1,0,1,"Doniphan, KS",7600
1886,31053,41.58071748,-96.65598179,12,0,12,"Dodge, NE",36565
1887,27039,44.02238415,-92.86244324,16,0,16,"Dodge, MN",20934
1888,13091,32.17265114,-83.16948926,17,0,17,"Dodge, GA",20605
1889,12029,29.60631086,-83.15724673,3,0,3,"Dixie, FL",16826
1890,38023,48.814938700000006,-103.4873611,1,0,1,"Divide, ND",2264
1891,51053,37.07544585,-77.63451754,7,0,7,"Dinwiddie, VA",28544
1892,48127,28.42270064,-99.75645095,1,0,1,"Dimmit, TX",10124
1893,45033,34.39007791,-79.37741872,7,0,7,"Dillon, SC",30479
1894,47043,36.14669837,-87.35891709,33,0,33,"Dickson, TN",53948
1895,20041,38.86600962,-97.15532383,1,0,1,"Dickinson, KS",18466
1896,19059,43.37787725,-95.1510206,1,0,1,"Dickinson, IA",17258
1897,48125,33.61616822,-100.7788855,1,0,1,"Dickens, TX",2211
1898,1053,31.1256789,-87.15918694,9,0,9,"Escambia, AL",36633
1899,40043,35.98772922,-99.00730714,2,0,2,"Dewey, OK",4891
1900,46039,44.75994309,-96.66943645,1,0,1,"Deuel, SD",4351
1901,5041,33.83011025,-91.25500948,6,0,6,"Desha, AR",11361
1902,41017,43.91570171,-121.2289121,55,0,55,"Deschutes, OR",197692
1903,19057,40.92012606,-91.18326592,7,0,7,"Des Moines, IA",38967
1904,48119,33.38570922,-95.66921122,1,0,1,"Delta, TX",5331
1905,40041,36.40823634,-94.80325046,72,0,72,"Delaware, OK",43009
1906,19055,42.47104597,-91.3664492,2,0,2,"Delaware, IA",17011
1907,6015,41.74228275,-123.8974063,2,0,2,"Del Norte, CA",27812
1908,39039,41.32398837,-84.49076944,12,0,12,"Defiance, OH",38087
1909,30023,46.05953325,-113.073353,3,0,3,"Deer Lodge, MT",9140
1910,47039,35.60048904,-88.11043779,3,0,3,"Decatur, TN",11663
1911,13087,30.87967778,-84.57619536,47,0,47,"Decatur, GA",26404
1912,17041,39.76768052,-88.21854195,11,0,11,"Douglas, IL",19465
1913,20045,38.88503636,-95.2925121,41,0,41,"Douglas, KS",122259
1914,27041,45.93348491,-95.45335469,1,0,1,"Douglas, MN",38141
1915,32005,38.912862,-119.6171333,13,0,13,"Douglas, NV",48905
1916,42049,41.99253829,-80.03301954,42,0,42,"Erie, PA",269728
1917,51595,36.69455571,-77.53406129,7,0,7,"Emporia, VA",5346
1918,49015,38.99617072,-110.7013958,3,0,3,"Emery, UT",10012
1919,13107,32.59221302,-82.30239915,9,0,9,"Emanuel, GA",22646
1920,16039,43.3507101,-115.4701578,18,0,18,"Elmore, ID",27511
1921,1051,32.59785413,-86.14415284,47,0,47,"Elmore, AL",81209
1922,20051,38.91458712,-99.31751551,4,0,4,"Ellis, KS",28553
1923,42047,41.42822061,-78.64524744,2,0,2,"Elk, PA",29910
1924,13105,34.11302332,-82.83936148,7,0,7,"Elbert, GA",19194
1925,6017,38.77965956,-120.5233166,35,0,35,"El Dorado, CA",192843
1926,21061,37.21218923,-86.23955613,7,0,7,"Edmonson, KY",12150
1927,45037,33.77221995,-81.96231108,10,0,10,"Edgefield, SC",27260
1928,38027,47.71701474,-98.90432337,1,0,1,"Eddy, ND",2287
1929,13101,30.71101099,-82.89687287,3,0,3,"Echols, GA",4006
1930,55035,44.726614,-91.28609183,21,0,21,"Eau Claire, WI",104646
1931,48133,32.32743996,-98.83243566,3,0,3,"Eastland, TX",18360
1932,22035,32.73926954,-91.23425694,1,0,1,"East Carroll, LA",6861
1933,47045,36.05931946,-89.41542855,22,0,22,"Dyer, TN",37159
1934,48131,27.68184592,-98.50864568,1,0,1,"Duval, TX",11157
1935,37061,34.93449805,-77.93140529,23,0,23,"Duplin, NC",58741
1936,55033,44.94562799,-91.8962481,9,0,9,"Dunn, WI",45368
1937,38025,47.35423935,-102.6160468,3,0,3,"Dunn, ND",4424
1938,29069,36.27167174,-90.09122243,17,0,17,"Dunklin, MO",29131
1939,49013,40.29772254,-110.425237,3,0,3,"Duchesne, UT",19938
1940,18037,38.36597551,-86.87924170000002,14,0,14,"Dubois, IN",42736
1941,55031,46.43222285,-91.91595768,7,0,7,"Douglas, WI",43150
1942,41019,43.27941273,-123.167291,20,0,20,"Douglas, OR",110980
1943,37041,36.12908077,-76.60118385,5,0,5,"Chowan, NC",13943
1944,1023,32.02227341,-88.26564429999998,12,0,12,"Choctaw, AL",12589
1945,48337,33.67521893,-97.72500958,5,0,5,"Montague, TX",19818
1946,5005,36.28784385,-92.33782872,4,0,4,"Baxter, AR",41932
1947,18007,40.60626947,-87.31093999,3,0,3,"Benton, IN",8748
1948,5007,36.33644656,-94.25680817,62,0,62,"Benton, AR",279141
1949,13017,31.76095874,-83.22145359,10,0,10,"Ben Hill, GA",16700
1950,27007,47.97373527,-94.93732139,5,0,5,"Beltrami, MN",47188
1951,33001,43.51637314,-71.41684235,24,0,24,"Belknap, NH",61303
1952,48025,28.41761668,-97.74215593,3,0,3,"Bee, TX",32565
1953,51019,37.3080028,-79.5281964,16,0,16,"Bedford, VA",78997
1954,40009,35.26862449,-99.68128023,2,0,2,"Beckham, OK",21859
1955,27005,46.93479392,-95.67158144,1,0,1,"Becker, MN",34423
1956,30001,45.13434354,-112.8984694,1,0,1,"Beaverhead, MT",9453
1957,40007,36.7496847,-100.4758872,1,0,1,"Beaver, OK",5311
1958,37013,35.48531943,-76.84325809,14,0,14,"Beaufort, NC",46994
1959,55007,46.52868768,-91.19716729,3,0,3,"Bayfield, WI",15036
1960,51017,38.05852573,-79.73912095,0,0,0,"Bath, VA",4147
1961,21007,37.05842757,-88.99427697,2,0,2,"Ballard, KY",7888
1962,21011,38.14735938,-83.74588932,3,0,3,"Bath, KY",12500
1963,20009,38.47889676,-98.75636726,5,0,5,"Barton, KS",25779
1964,29009,36.70978521,-93.82919888,2,0,2,"Barry, MO",35789
1965,55005,45.42372701,-91.84833627,6,0,6,"Barron, WI",45244
1966,21009,36.96469836,-85.93338945,5,0,5,"Barren, KY",44249
1967,45011,33.26679302,-81.43584352,5,0,5,"Barnwell, SC",20866
1968,38003,46.93579637,-98.06605978,2,0,2,"Barnes, ND",10415
1969,54001,39.1307219,-80.00350858,4,0,4,"Barbour, WV",16441
1970,1005,31.868263,-85.3871286,12,0,12,"Barbour, AL",24686
1971,20007,37.2288586,-98.68460053,1,0,1,"Barber, KS",4427
1972,16005,42.67002716,-112.2233311,5,0,5,"Bannock, ID",87808
1973,13011,34.35607081,-83.49644388,8,0,8,"Banks, GA",19234
1974,48019,29.74619598,-99.24598147,2,0,2,"Bandera, TX",23112
1975,27009,45.69804958,-93.99514135,1,0,1,"Benton, MN",40889
1976,28009,34.81681228,-89.18945516,5,0,5,"Benton, MS",8259
1977,29015,38.29503305,-93.28756116,3,0,3,"Benton, MO",19443
1978,47005,36.07110411,-88.06849355,4,0,4,"Benton, TN",16160
1979,48035,31.89978581,-97.63613524,1,0,1,"Bosque, TX",18685
1980,54005,38.01974191,-81.69888019,1,0,1,"Boone, WV",21457
1981,19015,42.03657094,-93.9313999,4,0,4,"Boone, IA",26234
1982,5009,36.3084504,-93.09374925,3,0,3,"Boone, AR",37432
1983,16019,43.38713372,-111.6161537,16,0,16,"Bonneville, ID",119062
1984,16017,48.29996017,-116.6017932,4,0,4,"Bonner, ID",45739
1985,17005,38.88829622,-89.43534887,4,0,4,"Bond, IL",16426
1986,46009,42.98914167,-97.88592746,4,0,4,"Bon Homme, SD",6901
1987,29017,37.32449052,-90.02725304,3,0,3,"Bollinger, MO",12133
1988,27013,44.03554215,-94.06699781,23,0,23,"Blue Earth, MN",67653
1989,1009,33.98210918,-86.56790593,17,0,17,"Blount, AL",57826
1990,47007,35.59942968,-85.20611967,8,0,8,"Bledsoe, TN",15064
1991,13023,32.43829035,-83.33035166,3,0,3,"Bleckley, GA",12873
1992,51021,37.13128068,-81.13599391,0,0,0,"Bland, VA",6280
1993,48031,30.26640707,-98.3999852,4,0,4,"Blanco, TX",11931
1994,42013,40.47961444,-78.34917412,12,0,12,"Blair, PA",121829
1995,37017,34.61296243,-78.56180059,2,0,2,"Bladen, NC",32722
1996,19013,42.4704581,-92.30524729,85,0,85,"Black Hawk, IA",131228
1997,16011,43.21672879999999,-112.3978437,2,0,2,"Bingham, ID",46811
1998,27011,45.42712824,-96.41403739,1,0,1,"Big Stone, MN",4991
1999,56003,44.52405055,-107.9960365,1,0,1,"Big Horn, WY",11790
2000,30003,45.42335905,-107.492347,2,0,2,"Big Horn, MT",13319
2001,1007,32.99642064,-87.12511459999996,18,0,18,"Bibb, AL",22394
2002,2050,60.90980451,-159.8561831,1,0,1,"Bethel, AK",18386
2003,13019,31.27590016,-83.22529920000002,8,0,8,"Berrien, GA",19397
2004,54003,39.46704621,-78.02414609,99,0,99,"Berkeley, WV",119171
2005,26019,44.63899297,-86.01608482,0,0,0,"Benzie, MI",17766
2006,45009,33.21927586,-81.05659969,7,0,7,"Bamberg, SC",14066
2007,13005,31.55456473,-82.45936528,14,0,14,"Bacon, GA",11164
2008,16021,48.76684761,-116.4630179,0,0,0,"Boundary, ID",12245
2009,37003,35.922379600000006,-81.17751948,3,0,3,"Alexander, NC",37497
2010,48001,31.81534745,-95.65354823,6,0,6,"Anderson, TX",57735
2011,20003,38.21413251,-95.29272815,0,0,0,"Anderson, KS",7858
2012,51009,37.60308293,-79.14548696,10,0,10,"Amherst, VA",31605
2013,51007,37.34081025,-77.98584649,10,0,10,"Amelia, VA",13145
2014,6005,38.44583082,-120.65696,7,0,7,"Amador, CA",39752
2015,6003,38.59678594,-119.8223594,2,0,2,"Alpine, CA",1129
2016,26007,45.03477666,-83.62212411,1,0,1,"Alpena, MI",28405
2017,45005,32.98837386,-81.35321066,5,0,5,"Allendale, SC",8688
2018,21003,36.75197631,-86.19457544,2,0,2,"Allen, KY",21315
2019,51005,37.78636074,-80.00222498,4,0,4,"Alleghany, VA",14860
2020,37005,36.49360862,-81.12857041,2,0,2,"Alleghany, NC",11137
2021,26005,42.59147037,-85.89102866,25,0,25,"Allegan, MI",118081
2022,40003,36.73090616,-98.32408495,1,0,1,"Alfalfa, OK",5702
2023,28003,34.88084463,-88.57996173,7,0,7,"Alcorn, MS",36953
2024,8009,37.31940883,-102.5603223,10,0,10,"Baca, CO",3581
2025,26001,44.6846864,-83.59507875,1,0,1,"Alcona, MI",10405
2026,51003,38.02080697,-78.55481085,53,0,53,"Albemarle, VA",109330
2027,56001,41.65498705,-105.7235415,5,0,5,"Albany, WY",38880
2028,37001,36.0434701,-79.39976137,43,0,43,"Alamance, NC",169509
2029,12001,29.67866525,-82.35928158,194,0,194,"Alachua, FL",269043
2030,53001,46.98299757,-118.5601734,39,0,39,"Adams, WA",19983
2031,39001,38.84541072,-83.4718964,3,0,3,"Adams, OH",27698
2032,31001,40.52449420000001,-98.50117804,62,0,62,"Adams, NE",31363
2033,17001,39.98815591,-91.18786813,27,0,27,"Adams, IL",65435
2034,16003,44.89333571,-116.4545247,1,0,1,"Adams, ID",4294
2035,29001,40.19058551,-92.60078167,12,0,12,"Adair, MO",25343
2036,19001,41.33075609,-94.47105874,1,0,1,"Adair, IA",7152
2037,51001,37.76707161,-75.63234615,15,0,15,"Accomack, VA",32316
2038,29003,39.98492163,-94.80163024,1,0,1,"Andrew, MO",17712
2039,48003,32.30468633,-102.6376548,13,0,13,"Andrews, TX",18705
2040,48005,31.25457347,-94.60901487,17,0,17,"Angelina, TX",86715
2041,27003,45.27476015,-93.24604565,76,0,76,"Anoka, MN",356921
2042,48015,29.88548725,-96.27736949,12,0,12,"Austin, TX",30032
2043,46003,43.71757685,-98.56050467,1,0,1,"Aurora, SD",2751
2044,51015,38.16404586,-79.12461614,18,0,18,"Augusta, VA",75558
2045,19009,41.6844628,-94.90581859,1,0,1,"Audubon, IA",5496
2046,28007,33.08658803,-89.57838564,25,0,25,"Attala, MS",18174
2047,40005,34.37366573,-96.03802487,1,0,1,"Atoka, OK",13758
2048,13003,31.29633502,-82.87545866,2,0,2,"Atkinson, GA",8165
2049,29005,40.43238737,-95.42970639,2,0,2,"Atchison, MO",5143
2050,20005,39.53185661,-95.30870026,3,0,3,"Atchison, KS",16073
2051,48013,28.89333001,-98.52730485,9,0,9,"Atascosa, TX",51153
2052,53003,46.18894415,-117.2022851,6,0,6,"Asotin, WA",22582
2053,5003,33.19153461,-91.7698471,11,0,11,"Ashley, AR",19657
2054,55003,46.31956891,-90.67837132,2,0,2,"Ashland, WI",15562
2055,39005,40.84772277,-82.27280781,6,0,6,"Ashland, OH",53484
2056,37009,36.43296207,-81.49862729,4,0,4,"Ashe, NC",27203
2057,23003,46.65926321,-68.59841248,2,0,2,"Aroostook, ME",67055
2058,48011,34.96507426,-101.3574874,1,0,1,"Armstrong, TX",1887
2059,5001,34.29145151,-91.37277296,2,0,2,"Arkansas, AR",17486
2060,26011,44.0636262,-83.89277559,7,0,7,"Arenac, MI",14883
2061,8007,37.19474156,-107.0476867,6,0,6,"Archuleta, CO",14029
2062,48007,28.10556197,-96.9995047,2,0,2,"Aransas, TX",23510
2063,51011,37.37569884,-78.81340003,7,0,7,"Appomattox, VA",15911
2064,13001,31.74847232,-82.28909114,14,0,14,"Appling, GA",18386
2065,4001,35.39465006,-109.4892383,110,0,110,"Apache, AZ",71887
2066,26009,44.99690221,-85.15503082,9,0,9,"Antrim, MI",23324
2067,31003,42.17695516,-98.0666283,1,0,1,"Antelope, NE",6298
2068,37007,34.97403241,-80.09953279,14,0,14,"Anson, NC",24446
2069,51023,37.55531756,-79.80982182,23,0,23,"Botetourt, VA",33419
2070,38011,46.11285362,-103.5203343,1,0,1,"Bowman, ND",3024
2071,55017,45.06939744,-91.28068855,20,0,20,"Chippewa, WI",64658
2072,32510,39.15509045,-119.7480219,25,0,25,"Carson City, NV",55916
2073,36009,42.24778241,-78.67923096,32,0,32,"Cattaraugus, NY",76117
2074,35003,33.91514144,-108.4046587,1,0,1,"Catron, NM",3527
2075,13047,34.89872298,-85.13757014,17,0,17,"Catoosa, GA",67580
2076,37033,36.39312665,-79.33353281,3,0,3,"Caswell, NC",22604
2077,48067,33.07499881,-94.34646905,6,0,6,"Cass, TX",30026
2078,31025,40.90899107,-96.13971217,3,0,3,"Cass, NE",26248
2079,27021,46.95043611,-94.32603968,4,0,4,"Cass, MN",29779
2080,19029,41.33149454,-94.92792482,1,0,1,"Cass, IA",12836
2081,21045,37.32533118,-84.92726209,1,0,1,"Casey, KY",16159
2082,30013,47.30797024,-111.3467922,13,0,13,"Cascade, MT",81366
2083,27019,44.82017001,-93.8009918,14,0,14,"Carver, MN",105089
2084,40019,34.25103751,-97.28552485,1,0,1,"Carter, OK",48111
2085,21043,38.31690743,-83.05092385,3,0,3,"Carter, KY",26797
2086,51035,36.73066666,-80.73455942,3,0,3,"Carroll, VA",29791
2087,47015,35.80990797,-86.05738983,7,0,7,"Cannon, TN",14678
2088,47017,35.97366108,-88.45189331,12,0,12,"Carroll, TN",27767
2089,39019,40.5789686,-81.09178213,14,0,14,"Carroll, OH",26914
2090,33003,43.87498583,-71.20430216,29,0,29,"Carroll, NH",48910
2091,28015,33.44834567,-89.91994479,9,0,9,"Carroll, MS",9947
2092,21041,38.66599534,-85.12601074,2,0,2,"Carroll, KY",10631
2093,19027,42.03617207,-94.86032705,1,0,1,"Carroll, IA",20165
2094,5015,36.34038560000001,-93.54270261,2,0,2,"Carroll, AR",28380
2095,51033,38.02679129,-77.34901405,9,0,9,"Caroline, VA",30725
2096,24011,38.87172293,-75.82904158,22,0,22,"Caroline, MD",33406
2097,27017,46.59180601,-92.67601019,27,0,27,"Carlton, MN",35871
2098,16029,42.77149116,-111.5597683,1,0,1,"Caribou, ID",7155
2099,56007,41.69357844,-106.9326084,4,0,4,"Carbon, WY",14800
2100,49007,39.64834818,-110.5872512,2,0,2,"Carbon, UT",20463
2101,19031,41.77233777,-91.13246684,22,0,22,"Cedar, IA",18627
2102,29039,37.72391475,-93.85445441,5,0,5,"Cedar, MO",14349
2103,31027,42.5988851,-97.25311951,0,0,0,"Cedar, NE",8402
2104,42027,40.92058903,-77.82200624,72,0,72,"Centre, PA",162385
2105,26033,46.29552653,-84.54353449,0,0,0,"Chippewa, MI",37349
2106,1021,32.85044126,-86.7173256,35,0,35,"Chilton, AL",44428
2107,5017,33.26458973,-91.29539209,7,0,7,"Chicot, AR",10118
2108,19037,43.06001295,-92.31773347,2,0,2,"Chickasaw, IA",11933
2109,31033,41.21999357,-102.9941693,2,0,2,"Cheyenne, NE",8910
2110,51041,37.37373208,-77.58680140000001,254,0,254,"Chesterfield, VA",352802
2111,45025,34.64137396,-80.15640140000002,28,0,28,"Chesterfield, SC",45650
2112,47023,35.42527478,-88.6095842,5,0,5,"Chester, TN",17297
2113,45023,34.69249168,-81.1583216,22,0,22,"Chester, SC",32244
2114,33005,42.92015988,-72.25311043,26,0,26,"Cheshire, NH",76085
2115,51550,36.67670048,-76.30545744,140,0,140,"Chesapeake, VA",244835
2116,31031,42.54502621,-101.1244332,1,0,1,"Cherry, NE",5689
2117,45021,35.05122251,-81.61828622,8,0,8,"Cherokee, SC",57300
2118,20021,37.16928494,-94.8462897,7,0,7,"Cherokee, KS",19939
2119,1019,34.17805983,-85.60638968,9,0,9,"Cherokee, AL",26196
2120,36017,42.49430041,-75.60887553,71,0,71,"Chenango, NY",47207
2121,47021,36.26136216,-87.08903581,19,0,19,"Cheatham, TN",40667
2122,35005,33.36406072,-104.4665365,19,0,19,"Chaves, NM",64615
2123,20019,37.14994405,-96.2454192,3,0,3,"Chautauqua, KS",3250
2124,13053,32.34341231,-84.78809239,5,0,5,"Chattahoochee, GA",10907
2125,13049,30.78371028,-82.13951596,4,0,4,"Charlton, GA",13392
2126,51037,37.01909701,-78.66314092,5,0,5,"Charlotte, VA",11880
2127,46023,43.20660134,-98.58856175,4,0,4,"Charles Mix, SD",9292
2128,51036,37.35358063,-77.05634116,9,0,9,"Charles City, VA",6963
2129,29041,39.51499357,-92.9629191,4,0,4,"Chariton, MO",7426
2130,48071,29.70972016,-94.67154501,31,0,31,"Chambers, TX",43837
2131,19033,43.08177563,-93.2612239,14,0,14,"Cerro Gordo, IA",42450
2132,30009,45.22850116,-109.0274047,6,0,6,"Carbon, MT",10725
2133,13043,32.40209349,-82.07702563,4,0,4,"Candler, GA",10803
2134,31013,42.22079243,-103.08788340000001,1,0,1,"Box Butte, NE",10783
2135,46013,45.58994323,-98.35165355,15,0,15,"Brown, SD",38839
2136,48051,30.49273808,-96.62158484,8,0,8,"Burleson, TX",18443
2137,38015,46.97847375,-100.4645214,52,0,52,"Burleigh, ND",95626
2138,38013,48.79094471,-102.5182117,2,0,2,"Burke, ND",2115
2139,17011,41.40385234,-89.5283051,7,0,7,"Bureau, IL",32628
2140,1011,32.10030533,-85.71265535,8,0,8,"Bullock, AL",10101
2141,51530,37.73484642,-79.35296097,4,0,4,"Buena Vista, VA",6478
2142,19021,42.73545875,-95.15100162,2,0,2,"Buena Vista, IA",19620
2143,51029,37.57242268,-78.52518834,22,0,22,"Buckingham, VA",17148
2144,51027,37.26818323,-82.03749726,12,0,12,"Buchanan, VA",21004
2145,19019,42.4709188,-91.83510825,8,0,8,"Buchanan, IA",21175
2146,40013,33.96472458,-96.25903472,5,0,5,"Bryan, OK",47995
2147,51025,36.76366949,-77.8593436,9,0,9,"Brunswick, VA",16231
2148,46015,43.71756379,-99.08118954,0,0,0,"Brule, SD",5297
2149,46011,44.36974375,-96.79079945,9,0,9,"Brookings, SD",35077
2150,56005,44.24886082,-105.5474404,13,0,13,"Campbell, WY",46341
2151,54009,40.27367263,-80.57915332,3,0,3,"Brooke, WV",21939
2152,30007,46.33277565,-111.4955813,4,0,4,"Broadwater, MT",6237
2153,51520,36.6163024,-82.16359122,1,0,1,"Bristol, VA",16762
2154,44001,41.71018079,-71.28652315,49,0,49,"Bristol, RI",48479
2155,19017,42.77461496,-92.31795937,9,0,9,"Bremer, IA",25062
2156,21027,37.77377239,-86.42885017,3,0,3,"Breckinridge, KY",20477
2157,21025,37.52333168,-83.31959161,1,0,1,"Breathitt, KY",12630
2158,54007,38.70036159,-80.72011184,1,0,1,"Braxton, WV",13957
2159,5011,33.46755808,-92.15980837,7,0,7,"Bradley, AR",10763
2160,42015,41.78869215,-76.51570822,19,0,19,"Bradford, PA",60323
2161,21023,38.69158994,-84.08532444,5,0,5,"Bracken, KY",8303
2162,21021,37.62680923,-84.8633779,12,0,12,"Boyle, KY",30060
2163,49003,41.52106798,-113.0832816,15,0,15,"Box Elder, UT",56046
2164,48053,30.78801353,-98.181887,7,0,7,"Burnet, TX",48155
2165,31021,41.85056773,-96.32605633,1,0,1,"Burt, NE",6459
2166,1013,31.75300095,-86.68057478,9,0,9,"Butler, AL",19448
2167,19023,42.73172833,-92.79015971,1,0,1,"Butler, IA",14439
2168,51031,37.20553386,-79.09678609,11,0,11,"Campbell, VA",54885
2169,47013,36.40355516,-84.15108559999999,12,0,12,"Campbell, TN",39842
2170,48063,32.97195142,-94.97790104,5,0,5,"Camp, TX",13094
2171,42023,41.43625568,-78.20376845,1,0,1,"Cameron, PA",4447
2172,22023,29.87592238,-93.19310676,2,0,2,"Cameron, LA",6973
2173,13039,30.92951916,-81.66601818,23,0,23,"Camden, GA",54666
2174,16025,43.46665742,-114.8065892,1,0,1,"Camas, ID",1106
2175,55015,44.0816316,-88.21780273,5,0,5,"Calumet, WI",50089
2176,48059,32.29760619,-99.37326312,1,0,1,"Callahan, TX",13943
2177,48057,28.47048236,-96.61633945,19,0,19,"Calhoun, TX",21290
2178,17013,39.16840183,-90.66330078,1,0,1,"Calhoun, IL",4739
2179,12013,30.40666734,-85.19394153,5,0,5,"Calhoun, FL",14105
2180,1015,33.77483727,-85.82630386,62,0,62,"Calhoun, AL",113605
2181,50005,44.46548598,-72.10314651,9,0,9,"Caledonia, VT",29993
2182,48055,29.83668859,-97.61814775,6,0,6,"Caldwell, TX",43664
2183,37027,35.95204977,-81.54799522,19,0,19,"Caldwell, NC",82178
2184,29025,39.65620858,-93.98308093,1,0,1,"Caldwell, MO",9020
2185,22021,32.0902519,-92.11752148,18,0,18,"Caldwell, LA",9918
2186,21033,37.14749129,-87.86948214,10,0,10,"Caldwell, KY",12747
2187,6009,38.20537103,-120.552913,9,0,9,"Calaveras, CA",45905
2188,49005,41.72330587,-111.7443667,37,0,37,"Cache, UT",128289
2189,54011,38.42424062,-82.23855912,28,0,28,"Cabell, WV",91945
2190,13035,33.283094500000004,-83.95435040000002,36,0,36,"Butts, GA",24936
2191,46019,44.90608745,-103.5079318,0,0,0,"Butte, SD",10429
2192,6007,39.66727762,-121.6005252,16,0,16,"Butte, CA",219186
2193,29023,36.71462476,-90.40421163,16,0,16,"Butler, MO",42478
2194,20015,37.78134351,-96.83878537,10,0,10,"Butler, KS",66911
2195,48165,32.74055318,-102.6353295,2,0,2,"Gaines, TX",21492
2196,51640,36.66601852,-80.91703124,1,0,1,"Galax, VA",6347
2197,17059,37.76430935,-88.22953869,2,0,2,"Gallatin, IL",4828
2198,30051,48.56084317,-111.024307,1,0,1,"Liberty, MT",2337
2199,37109,35.48508185,-81.21740317,15,0,15,"Lincoln, NC",86111
2200,35027,33.74526079,-105.4586166,1,0,1,"Lincoln, NM",19572
2201,32017,37.64268459,-114.8790388,1,0,1,"Lincoln, NV",5183
2202,27081,44.41311883,-96.26688165,2,0,2,"Lincoln, MN",5639
2203,23015,44.05996956,-69.54227124,12,0,12,"Lincoln, ME",34634
2204,22061,32.6003154,-92.6659741,41,0,41,"Lincoln, LA",46742
2205,21137,37.45475628,-84.6565327,1,0,1,"Lincoln, KY",24549
2206,16063,43.0012336,-114.1358773,15,0,15,"Lincoln, ID",5366
2207,13181,33.79201475,-82.45024131,9,0,9,"Lincoln, GA",7921
2208,8073,38.98749519,-103.5136649,2,0,2,"Lincoln, CO",5701
2209,5079,33.95317155,-91.74002806,59,0,59,"Lincoln, AR",13024
2210,1083,34.81185586,-86.98310072,37,0,37,"Limestone, AL",98915
2211,48291,30.15152688,-94.81205615,23,0,23,"Liberty, TX",88219
2212,13179,31.82588896,-81.49251135,26,0,26,"Liberty, GA",61435
2213,26091,41.89475156,-84.06603727,56,0,56,"Lenawee, MI",98451
2214,12077,30.23766008,-84.8829258,2,0,2,"Liberty, FL",8354
2215,51678,37.78258621,-79.44262866,3,0,3,"Lexington, VA",7446
2216,30049,47.12610041,-112.394698,16,0,16,"Lewis and Clark, MT",69432
2217,54041,38.9947249,-80.49988181,2,0,2,"Lewis, WV",15907
2218,47101,35.52853208,-87.49022694,2,0,2,"Lewis, TN",12268
2219,36049,43.7844157,-75.44903992,7,0,7,"Lewis, NY",26296
2220,21135,38.53184419,-83.37735618,2,0,2,"Lewis, KY",13275
2221,16061,46.23315327,-116.434146,0,0,0,"Lewis, ID",3838
2222,12075,29.31829741,-82.74007147,7,0,7,"Levy, FL",41503
2223,21133,37.12306748,-82.85346474,1,0,1,"Letcher, KY",21553
2224,21131,37.09246661,-83.37999606,2,0,2,"Leslie, KY",9877
2225,48289,31.29872538,-95.9936328,3,0,3,"Leon, TX",17404
2226,12073,30.45955727,-84.27491114,154,0,154,"Leon, FL",293582
2227,40081,35.70270942,-96.8812462,10,0,10,"Lincoln, OK",34877
2228,41041,44.64252874,-123.869912,4,0,4,"Lincoln, OR",49962
2229,46083,43.27841182,-96.7203905,65,0,65,"Lincoln, SD",61128
2230,47103,35.13738622,-86.58910106,9,0,9,"Lincoln, TN",34366
2231,13187,34.57286511,-84.00425681,11,0,11,"Lumpkin, GA",33610
2232,26095,46.47227431,-85.54471223,1,0,1,"Luce, MI",6229
2233,28087,33.47386518,-88.44191529999998,27,0,27,"Lowndes, MS",58595
2234,1085,32.1597283,-86.65158371,20,0,20,"Lowndes, AL",9726
2235,40085,33.95273467,-97.23906784,2,0,2,"Love, OK",10253
2236,51109,37.97850256,-77.96274807,29,0,29,"Louisa, VA",37591
2237,19115,41.21842119,-91.26102611,166,0,166,"Louisa, IA",11035
2238,47105,35.73939663,-84.31145275,17,0,17,"Loudon, TN",54068
2239,35028,35.86631386,-106.3134985,6,0,6,"Los Alamos, NM",19369
2240,5085,34.75392199,-91.88742357,30,0,30,"Lonoke, AR",73309
2241,13183,31.75218791,-81.74952375,2,0,2,"Long, GA",19559
2242,40083,35.91899576,-97.44352845,7,0,7,"Logan, OK",48011
2243,39091,40.38996525,-83.76784341,8,0,8,"Logan, OH",45672
2244,31113,41.56650314,-100.4817851,0,0,0,"Logan, NE",748
2245,21141,36.85949479,-86.877635,10,0,10,"Logan, KY",27102
2246,17107,40.12581572,-89.36638784,4,0,4,"Logan, IL",28618
2247,8075,40.7249637,-103.110817,13,0,13,"Logan, CO",22409
2248,5083,35.21413234,-93.71951016,2,0,2,"Logan, AR",21466
2249,48299,30.70645047,-98.68475262,3,0,3,"Llano, TX",21795
2250,29117,39.78110272,-93.54645978,2,0,2,"Livingston, MO",15227
2251,21139,37.21137452,-88.34797529,1,0,1,"Livingston, KY",9194
2252,17105,40.89188292,-88.55784752,17,0,17,"Livingston, IL",35648
2253,48297,28.35101362,-98.1246786,3,0,3,"Live Oak, TX",12207
2254,20107,38.21267844,-94.84254089,6,0,6,"Linn, KS",9703
2255,56023,42.26376367,-110.6563997,5,0,5,"Lincoln, WY",19830
2256,54043,38.172154,-82.07017953,1,0,1,"Lincoln, WV",20409
2257,53043,47.57705241,-118.4194388,2,0,2,"Lincoln, WA",10939
2258,37107,35.24032589999999,-77.64245615,15,0,15,"Lenoir, NC",55949
2259,26089,44.94430054,-85.80150326,5,0,5,"Leelanau, MI",21761
2260,51111,36.94618528,-78.24133319,3,0,3,"Lunenburg, VA",12196
2261,31107,42.63758421,-97.89178836,2,0,2,"Knox, NE",8332
2262,6033,39.10124298,-122.7536244,5,0,5,"Lake, CA",64386
2263,55065,42.66005229,-90.1317729,3,0,3,"Lafayette, WI",16665
2264,12067,29.98484137,-83.18166636,1,0,1,"Lafayette, FL",8422
2265,5073,33.24116713,-93.60677071,4,0,4,"Lafayette, AR",6624
2266,27073,44.9973857,-96.17488219,1,0,1,"Lac qui Parle, MN",6623
2267,20099,37.19113093,-95.29849679,20,0,20,"Labette, KS",19618
2268,8067,37.28632032,-107.8429014,44,0,44,"La Plata, CO",56221
2269,4012,33.72854224,-113.9810029,5,0,5,"La Paz, AZ",21108
2270,55063,43.90632465,-91.11451093,25,0,25,"La Crosse, WI",118016
2271,19109,43.20405458,-94.20691791,1,0,1,"Kossuth, IA",14813
2272,16055,47.67282258,-116.7020872,45,0,45,"Kootenai, ID",165697
2273,27071,48.24539665,-93.78352843,1,0,1,"Koochiching, MN",12229
2274,48275,33.60519951,-99.7422906,1,0,1,"Knox, TX",3664
2275,23013,44.11486325,-69.10529169,12,0,12,"Knox, ME",39772
2276,51105,36.70586667,-83.12606515,6,0,6,"Lee, VA",23423
2277,21121,36.89225732,-83.85403396,1,0,1,"Knox, KY",31145
2278,18083,38.68861576,-87.4194665,16,0,16,"Knox, IN",36594
2279,17095,40.93148779,-90.21330340000002,2,0,2,"Knox, IL",49699
2280,21119,37.35388197,-82.94981134,1,0,1,"Knott, KY",14806
2281,41035,42.68762984,-121.64964609999998,26,0,26,"Klamath, OR",68238
2282,53037,47.12521214,-120.679439,14,0,14,"Kittitas, WA",47935
2283,40075,34.91671958,-98.97720696,2,0,2,"Kiowa, OK",8708
2284,46077,44.36956169,-97.4913945,0,0,0,"Kingsbury, SD",4939
2285,40073,35.94530008,-97.94193268,6,0,6,"Kingfisher, OK",15765
2286,51097,37.71044922,-76.88689628,2,0,2,"King and Queen, VA",7025
2287,51101,37.70965316,-77.09384941,2,0,2,"King William, VA",17148
2288,51099,38.26818502,-77.15852768,17,0,17,"King George, VA",26836
2289,31105,41.19774275,-103.7148131,9,0,9,"Kimball, NE",3632
2290,8065,39.20278823,-106.3555697,5,0,5,"Lake, CO",8127
2291,26085,43.99050893,-85.802173,2,0,2,"Lake, MI",11853
2292,30047,47.64514965,-114.0898013,5,0,5,"Lake, MT",30458
2293,46079,44.02193107,-97.12926365,2,0,2,"Lake, SD",12797
2294,48287,30.31120597,-96.97045773,2,0,2,"Lee, TX",17239
2295,37105,35.47623147,-79.17569362,16,0,16,"Lee, NC",61779
2296,19111,40.64181461,-91.48183025,2,0,2,"Lee, IA",33657
2297,17103,41.74583951,-89.29977132,15,0,15,"Lee, IL",34096
2298,35025,32.79215361,-103.4123733,2,0,2,"Lea, NM",71070
2299,27079,44.37136597,-93.72844721,21,0,21,"Le Sueur, MN",28887
2300,40079,34.89851864,-94.70392124,4,0,4,"Le Flore, OK",49853
2301,47099,35.21675201,-87.39787695,15,0,15,"Lawrence, TN",44142
2302,46081,44.35919441,-103.7929428,9,0,9,"Lawrence, SD",25844
2303,39087,38.59743452,-82.53466552,17,0,17,"Lawrence, OH",59463
2304,28077,31.55147224,-90.10841127,7,0,7,"Lawrence, MS",12586
2305,21127,38.07136018,-82.72882223,1,0,1,"Lawrence, KY",15317
2306,17101,38.71987914,-87.72884035,2,0,2,"Lawrence, IL",15678
2307,1079,34.52041498,-87.31069453,8,0,8,"Lawrence, AL",32924
2308,48285,29.38508402,-96.93186692,4,0,4,"Lavaca, TX",20154
2309,47097,35.75893438,-89.63015909999999,9,0,9,"Lauderdale, TN",25633
2310,16057,46.81587887,-116.7113698,3,0,3,"Latah, ID",40108
2311,8071,37.3153406,-104.0376458,2,0,2,"Las Animas, CO",14506
2312,21123,37.54567114,-85.70138352,4,0,4,"Larue, KY",14398
2313,56021,41.30702520000001,-104.6887497,64,0,64,"Laramie, WY",99500
2314,51103,37.71889653,-76.46400482,1,0,1,"Lancaster, VA",10603
2315,48281,31.19531316,-98.24206613,3,0,3,"Lampasas, TX",21428
2316,48279,34.06859623,-102.3516289,2,0,2,"Lamb, TX",12893
2317,48277,33.66981763,-95.57404777,7,0,7,"Lamar, TX",49859
2318,13171,33.07841647,-84.14263877,21,0,21,"Lamar, GA",19077
2319,1075,33.77995024,-88.09668032,7,0,7,"Lamar, AL",13805
2320,47095,36.34180170000001,-89.48921915,4,0,4,"Lake, TN",7016
2321,35029,32.18179341,-107.75088259999998,2,0,2,"Luna, NM",23709
2322,42081,41.34310539,-77.06629984,30,0,30,"Lycoming, PA",113299
2323,21077,38.75398691,-84.8558382,1,0,1,"Gallatin, KY",8869
2324,51117,36.67882005,-78.36131056,57,0,57,"Mecklenburg, VA",30587
2325,54055,37.40481169,-81.11023142,8,0,8,"Mercer, WV",58758
2326,42085,41.30248872,-80.25816981,47,0,47,"Mercer, PA",109424
2327,38057,47.31213126,-101.8318399,0,0,0,"Mercer, ND",8187
2328,21167,37.81474237,-84.87488475,9,0,9,"Mercer, KY",21933
2329,17131,41.20596782,-90.74290052,3,0,3,"Mercer, IL",15437
2330,55078,45.00422544,-88.70950714,1,0,1,"Menominee, WI",4556
2331,26109,45.58038692,-87.55370409,1,0,1,"Menominee, MI",22780
2332,21165,37.94090733,-83.59985712,3,0,3,"Menifee, KY",6489
2333,6045,39.4381191,-123.3911313,4,0,4,"Mendocino, CA",86749
2334,17129,40.02742725,-89.80246001,2,0,2,"Menard, IL",12196
2335,47121,35.51558739,-84.81482914,3,0,3,"Meigs, TN",12422
2336,39105,39.09224872,-82.0305041,2,0,2,"Meigs, OH",22907
2337,27093,45.12328869,-94.52839455,3,0,3,"Meeker, MN",23222
2338,30059,46.59907074,-110.8898557,1,0,1,"Meagher, MT",1862
2339,40089,34.11664328,-94.77222373,7,0,7,"McCurtain, OK",32832
2340,46093,44.56676791,-102.7162741,1,0,1,"Meade, SD",28332
2341,20113,38.39184858,-97.64769869,14,0,14,"McPherson, KS",28542
2342,47109,35.17468549,-88.5647812,9,0,9,"McNairy, TN",25694
2343,47107,35.42812616,-84.61520715,5,0,5,"McMinn, TN",53794
2344,27085,44.82367677,-94.27287017,2,0,2,"McLeod, MN",35893
2345,38055,47.60766714,-101.3182418,3,0,3,"McLean, ND",9450
2346,38053,47.74133370000001,-103.395905,9,0,9,"McKenzie, ND",15024
2347,42083,41.80938602,-78.56478358,4,0,4,"McKean, PA",40625
2348,40091,35.37235506,-95.66599306,1,0,1,"McIntosh, OK",19596
2349,38051,46.11182017,-99.44145858,1,0,1,"McIntosh, ND",2497
2350,54047,37.38002939,-81.65083669,6,0,6,"McDowell, WV",17624
2351,37111,35.67736232,-82.0482425,20,0,20,"McDowell, NC",45756
2352,17109,40.45674722,-90.67775541,2,0,2,"McDonough, IL",29682
2353,13199,33.04163534,-84.68859732,26,0,26,"Meriwether, GA",21167
2354,31121,41.16624273,-98.0374887,2,0,2,"Merrick, NE",7755
2355,33013,43.29662971,-71.6811573,81,0,81,"Merrimack, NH",151391
2356,8077,39.01787888,-108.469799,35,0,35,"Mesa, CO",154210
2357,54063,37.56274716,-80.54577965,1,0,1,"Monroe, WV",13275
2358,47123,35.44550387,-84.24902965,9,0,9,"Monroe, TN",46545
2359,39111,39.72984936,-81.08464734,2,0,2,"Monroe, OH",13654
2360,21171,36.71225341,-85.71596443,3,0,3,"Monroe, KY",10650
2361,5095,34.6815935,-91.20540287,2,0,2,"Monroe, AR",6701
2362,19133,42.05220391,-95.95743843,6,0,6,"Monona, IA",8615
2363,29135,38.63571781,-92.57976951,4,0,4,"Moniteau, MO",16132
2364,4015,35.70471703,-113.7577902,45,0,45,"Mohave, AZ",212181
2365,8081,40.61810999,-108.2070876,3,0,3,"Moffat, CO",13283
2366,48335,32.30623474,-100.9212058,1,0,1,"Mitchell, TX",8545
2367,37121,36.01059309,-82.1582442,4,0,4,"Mitchell, NC",14964
2368,20123,39.39331582,-98.20906732,2,0,2,"Mitchell, KS",5979
2369,19131,43.35638371,-92.78887719,2,0,2,"Mitchell, IA",10586
2370,5093,35.76271485,-90.05194370000002,7,0,7,"Mississippi, AR",40651
2371,16067,42.85518524,-113.6357257,6,0,6,"Minidoka, ID",21039
2372,54059,37.73048351,-82.13338365,1,0,1,"Mingo, WV",23424
2373,54057,39.41561583,-78.94104895,6,0,6,"Mineral, WV",26868
2374,8079,37.66954283,-106.9281698,2,0,2,"Mineral, CO",769
2375,46097,44.02197882,-97.60992207,1,0,1,"Miner, SD",2216
2376,19129,41.03299766,-95.61920963,2,0,2,"Mills, IA",15109
2377,13201,31.16568912,-84.73151117,15,0,15,"Miller, GA",5718
2378,5091,33.31403423,-93.89285258,28,0,28,"Miller, AR",43257
2379,48331,30.78581830000001,-96.97718698,8,0,8,"Milam, TX",24823
2380,42087,40.61116939,-77.61070738,15,0,15,"Mifflin, PA",46138
2381,51119,37.63191998,-76.55064617,3,0,3,"Middlesex, VA",10582
2382,20121,38.56383358,-94.83832189,4,0,4,"Miami, KS",34237
2383,18103,40.76940965,-86.04525048,17,0,17,"Miami, IN",35516
2384,29119,36.62869595,-94.34867205,4,0,4,"McDonald, MO",22837
2385,48307,31.1925468,-99.34682807,3,0,3,"McCulloch, TX",7984
2386,46085,43.89522709,-99.85201878,2,0,2,"Lyman, SD",3781
2387,29123,37.47865134,-90.3467143,1,0,1,"Madison, MO",12088
2388,17121,38.64963204,-88.91899208,17,0,17,"Marion, IL",37205
2389,13197,32.3483402,-84.52733571,17,0,17,"Marion, GA",8359
2390,5089,36.26844485,-92.68451899,1,0,1,"Marion, AR",16694
2391,29125,38.16193985,-91.92249662,2,0,2,"Maries, MO",8697
2392,55071,44.11946801,-87.80928853,4,0,4,"Manitowoc, WI",78981
2393,26101,44.33352407,-86.05626916,10,0,10,"Manistee, MI",24558
2394,51685,38.77058531,-77.44399307,14,0,14,"Manassas Park, VA",17478
2395,41045,43.1937027,-117.6227395,4,0,4,"Malheur, OR",30571
2396,27087,47.32557075,-95.80921485,1,0,1,"Mahnomen, MN",5527
2397,19123,41.33521503,-92.64083907,7,0,7,"Mahaska, IA",22095
2398,51113,38.41531222,-78.28220331,8,0,8,"Madison, VA",13261
2399,48313,30.96694679,-95.93003775,1,0,1,"Madison, TX",14284
2400,47113,35.61181957,-88.84076036,73,0,73,"Madison, TN",97984
2401,22065,32.36918118,-91.23973355,2,0,2,"Madison, LA",10951
2402,21147,36.73874143,-84.48102924,9,0,9,"McCreary, KY",17231
2403,16065,43.78141028,-111.65384740000002,5,0,5,"Madison, ID",39907
2404,12079,30.44396917,-83.47398594,15,0,15,"Madison, FL",18493
2405,5087,36.01038185,-93.72524943,1,0,1,"Madison, AR",16576
2406,17117,39.26119767,-89.92424028,17,0,17,"Macoupin, IL",44926
2407,29121,39.83049768,-92.56453089,2,0,2,"Macon, MO",15117
2408,13193,32.35207048,-84.04234127,47,0,47,"Macon, GA",12947
2409,26097,46.07028979,-85.04980537,4,0,4,"Mackinac, MI",10799
2410,32019,39.01777974,-119.1870479,10,0,10,"Lyon, NV",57510
2411,27083,44.41327865,-95.83806103,5,0,5,"Lyon, MN",25474
2412,20111,38.45576156,-96.15275715,32,0,32,"Lyon, KS",33195
2413,19119,43.38107862,-96.20926845,4,0,4,"Lyon, IA",11755
2414,48305,33.17657705,-101.8162849,5,0,5,"Lynn, TX",5951
2415,51680,37.40021399,-79.19888138,34,0,34,"Lynchburg, VA",82168
2416,19125,41.33445101,-93.09934783,3,0,3,"Marion, IA",33253
2417,20115,38.35855394,-97.0985251,5,0,5,"Marion, KS",11884
2418,21155,37.55218078,-85.26898542,11,0,11,"Marion, KY",19273
2419,28091,31.23132643,-89.8209217,34,0,34,"Marion, MS",24573
2420,40087,35.01123903,-97.44572302,19,0,19,"McClain, OK",40474
2421,48323,28.7429195,-100.3157686,10,0,10,"Maverick, TX",58722
2422,47119,35.6187413,-87.07462444,33,0,33,"Maury, TN",96387
2423,51115,37.44164146,-76.34098896,3,0,3,"Mathews, VA",8834
2424,2170,62.31305045,-149.5741743,15,0,15,"Matanuska-Susitna, AK",108317
2425,17127,37.22078441,-88.71036614,4,0,4,"Massac, IL",13772
2426,54053,38.77071799,-82.02524219,9,0,9,"Mason, WV",26516
2427,53045,47.35007586,-123.1863685,19,0,19,"Mason, WA",66768
2428,48319,30.71780434,-99.22629416,1,0,1,"Mason, TX",4274
2429,26105,43.99509218,-86.24988902,3,0,3,"Mason, MI",29144
2430,21161,38.59471935,-83.82151043,6,0,6,"Mason, KY",17070
2431,17125,40.23917274,-89.91824452,3,0,3,"Mason, IL",13359
2432,51690,36.68212094,-79.86352771,0,0,0,"Martinsville, VA",12554
2433,48317,32.30600051,-101.9513518,2,0,2,"Martin, TX",5771
2434,37117,35.84326734,-77.10860251,7,0,7,"Martin, NC",22440
2435,21159,37.79990579,-82.51247478,1,0,1,"Martin, KY",11195
2436,18101,38.7099921,-86.80373186,5,0,5,"Martin, IN",10255
2437,54051,39.86064362,-80.66591062,7,0,7,"Marshall, WV",30531
2438,46091,45.75870838,-97.59855639,1,0,1,"Marshall, SD",4935
2439,40095,34.02311222,-96.76855464,1,0,1,"Marshall, OK",16931
2440,21157,36.88007070000001,-88.32803576,12,0,12,"Marshall, KY",31100
2441,19127,42.03586837,-92.9990819,44,0,44,"Marshall, IA",39369
2442,18099,41.32467367,-86.26185087,19,0,19,"Marshall, IN",46258
2443,17123,41.0327901,-89.34510444,2,0,2,"Marshall, IL",11438
2444,55077,43.81911946,-89.40073763,3,0,3,"Marquette, WI",15574
2445,45069,34.59905577,-79.67561152,15,0,15,"Marlboro, SC",26118
2446,39101,40.58610662,-83.15736305,164,0,164,"Marion, OH",65093
2447,2130,55.57445008,-130.975561,15,0,15,"Ketchikan Gateway, AK",13901
2448,48265,30.06040006,-99.34930144,3,0,3,"Kerr, TX",52600
2449,19107,41.33649833,-92.1785067,2,0,2,"Keokuk, IA",10246
2450,48185,30.54579585,-95.98902499,7,0,7,"Grimes, TX",28880
2451,36041,43.66146647,-74.49721957,3,0,3,"Hamilton, NY",4416
2452,31081,40.87349452,-98.02099117,13,0,13,"Hamilton, NE",9324
2453,20075,37.99978709,-101.7921066,1,0,1,"Hamilton, KS",2539
2454,19079,42.38382428,-93.70197703,2,0,2,"Hamilton, IA",14773
2455,12047,30.49673973,-82.94998918,2,0,2,"Hamilton, FL",14428
2456,51083,36.76654925,-78.93512622,7,0,7,"Halifax, VA",33911
2457,1065,32.76039258,-87.63284988,18,0,18,"Hale, AL",14651
2458,19077,41.68378965,-94.50111014,3,0,3,"Guthrie, IA",10689
2459,12045,29.93543004,-85.24270990000002,1,0,1,"Gulf, FL",13639
2460,39059,40.05026529,-81.49248905,10,0,10,"Guernsey, OH",38875
2461,48187,29.58165339,-97.94786822,50,0,50,"Guadalupe, TX",166847
2462,19075,42.40183723,-92.78829551,1,0,1,"Grundy, IA",12232
2463,17063,41.28569601,-88.41905692,24,0,24,"Grundy, IL",51054
2464,28043,33.77036166,-89.80245083,14,0,14,"Grenada, MS",20758
2465,1063,32.85504247,-87.95684022,18,0,18,"Greene, AL",8111
2466,48183,32.47940482,-94.81591935,47,0,47,"Gregg, TX",123945
2467,45047,34.15272415,-82.12715789,19,0,19,"Greenwood, SC",70811
2468,20073,37.8774388,-96.23250453,1,0,1,"Greenwood, KS",5982
2469,21089,38.54332505,-82.9215658,7,0,7,"Greenup, KY",35098
2470,51081,36.67878901,-77.56351439,16,0,16,"Greensville, VA",11336
2471,4011,33.21498827,-109.2405279,2,0,2,"Greenlee, AZ",9498
2472,51079,38.29545894,-78.46525378,5,0,5,"Greene, VA",19819
2473,42059,39.85746531,-80.22357106,23,0,23,"Greene, PA",36233
2474,37079,35.48544173,-77.67578087,16,0,16,"Greene, NC",21069
2475,36039,42.275797,-74.12384884,73,0,73,"Greene, NY",47188
2476,28041,31.21444233,-88.63922281,3,0,3,"Greene, MS",13586
2477,19073,42.03614551,-94.39658081,1,0,1,"Greene, IA",8888
2478,17061,39.35907414,-90.388865,1,0,1,"Greene, IL",12969
2479,48193,31.70470573,-98.11083887,3,0,3,"Hamilton, TX",8461
2480,46057,44.67385954,-97.18829593,1,0,1,"Hamlin, SD",6164
2481,54027,39.32103553,-78.60826476,7,0,7,"Hampshire, WV",23175
2482,45049,32.77419582,-81.13845571,12,0,12,"Hampton, SC",19222
2483,48211,35.83764858,-100.2703577,1,0,1,"Hemphill, TX",3819
2484,37087,35.55269063,-82.98196486,4,0,4,"Haywood, NC",62317
2485,15001,19.60121157,-155.5210167,41,0,41,"Hawaii, HI",201513
2486,20079,38.04293782,-97.42747573,5,0,5,"Harvey, KS",34429
2487,21099,37.29943898,-85.88461055,1,0,1,"Hart, KY",19035
2488,13147,34.34626973,-82.96567682,5,0,5,"Hart, GA",26205
2489,51660,38.43542574,-78.87536254,101,0,101,"Harrisonburg, VA",53016
2490,29081,40.35570088,-93.99222144,6,0,6,"Harrison, MO",8352
2491,21097,38.44188174,-84.32869741,14,0,14,"Harrison, KY",18886
2492,19085,41.68330137,-95.81558439,12,0,12,"Harrison, IA",14049
2493,24025,39.55010644,-76.30775940000002,152,0,152,"Harford, MD",255441
2494,54031,39.00683177,-78.85855301,2,0,2,"Hardy, WV",13776
2495,47071,35.19732531,-88.18593755,2,0,2,"Hardin, TN",25652
2496,39065,40.66015414,-83.65929931,11,0,11,"Hardin, OH",31365
2497,21093,37.6976111,-85.96319251,25,0,25,"Hardin, KY",110958
2498,19083,42.38353877,-93.23654611,1,0,1,"Hardin, IA",16846
2499,47069,35.20772017,-88.99161161,7,0,7,"Hardeman, TN",25050
2500,12049,27.49293939,-81.80956574,3,0,3,"Hardee, FL",26937
2501,48195,36.27743284,-101.3545796,1,0,1,"Hansford, TX",5399
2502,51085,37.7583355,-77.49464673,53,0,53,"Hanover, VA",107766
2503,54029,40.51943859,-80.57461608,7,0,7,"Hancock, WV",28810
2504,47067,36.52692871,-83.22375847,0,0,0,"Hancock, TN",6620
2505,23009,44.59816444,-68.38401854,5,0,5,"Hancock, ME",54987
2506,21091,37.83766422,-86.78280584,1,0,1,"Hancock, KY",8722
2507,19081,43.08178477,-93.73454884,3,0,3,"Hancock, IA",10630
2508,17067,40.40423981,-91.16313899,3,0,3,"Hancock, IL",17708
2509,13141,33.2721566,-82.99766919,5,0,5,"Hancock, GA",8457
2510,5055,36.11735460000001,-90.55832668,6,0,6,"Greene, AR",45325
2511,54025,37.9463652,-80.45335881,3,0,3,"Greenbrier, WV",34662
2512,44003,41.67106337,-71.57641596,244,0,244,"Kent, RI",164292
2513,47053,35.99438059,-88.93358327,21,0,21,"Gibson, TN",49133
2514,30037,46.3816474,-109.1768522,1,0,1,"Golden Valley, MT",821
2515,13127,31.23279254,-81.53811412,41,0,41,"Glynn, GA",85292
2516,51073,37.40809042,-76.53524337,20,0,20,"Gloucester, VA",37348
2517,6021,39.59875897,-122.3938452,4,0,4,"Glenn, CA",28393
2518,26051,43.98901072,-84.38774817,6,0,6,"Gladwin, MI",25449
2519,30035,48.70513576,-112.9934235,4,0,4,"Glacier, MT",13753
2520,8047,39.85646523,-105.5252597,1,0,1,"Gilpin, CO",6243
2521,13123,34.69316688,-84.45802506,7,0,7,"Gilmer, GA",31369
2522,48171,30.31824095,-98.94676915,1,0,1,"Gillespie, TX",26988
2523,51071,37.31234791,-80.70636931,4,0,4,"Giles, VA",16720
2524,47055,35.20222469,-87.03992678,3,0,3,"Giles, TN",29464
2525,12041,29.72856978,-82.79880657,6,0,6,"Gilchrist, FL",18582
2526,4007,33.80190085,-110.8132779,3,0,3,"Gila, AZ",54018
2527,18051,38.30393723,-87.58054938,4,0,4,"Gibson, IN",33659
2528,55047,43.80025981,-89.04679553,1,0,1,"Green Lake, WI",18913
2529,28039,30.86259065,-88.64436789,8,0,8,"George, MS",24500
2530,29075,40.21097916,-94.40944419,1,0,1,"Gentry, MO",6571
2531,1061,31.09389027,-85.83572839,2,0,2,"Geneva, AL",26271
2532,16045,44.06482372,-116.398376,9,0,9,"Gem, ID",18112
2533,20061,38.99871131,-96.7577178,9,0,9,"Geary, KS",31670
2534,37073,36.44667547,-76.69749701,4,0,4,"Gates, NC",11562
2535,29073,38.43947277,-91.50847147,2,0,2,"Gasconade, MO",14706
2536,40049,34.70418038,-97.30811132,10,0,10,"Garvin, OK",27711
2537,24023,39.52786077,-79.27355126,4,0,4,"Garrett, MD",29014
2538,21079,37.6388668,-84.53289319,1,0,1,"Garrard, KY",17666
2539,5051,34.57692074,-93.14921604,103,0,103,"Garland, AR",99386
2540,49017,37.85447192,-111.4418764,1,0,1,"Garfield, UT",5051
2541,30031,45.54486106,-111.1692571,139,0,139,"Gallatin, MT",114434
2542,48175,28.65696592,-97.42760647,5,0,5,"Goliad, TX",7658
2543,48177,29.45634206,-97.49424032,2,0,2,"Gonzales, TX",20837
2544,51075,37.71714806,-77.90381514,40,0,40,"Goochland, VA",23753
2545,27049,44.40849741,-92.7234195,17,0,17,"Goodhue, MN",46340
2546,55045,42.6794956,-89.60243287,9,0,9,"Green, WI",36960
2547,21087,37.26484328,-85.5540745,1,0,1,"Green, KY",10941
2548,51077,36.65677234,-81.23215889,0,0,0,"Grayson, VA",15550
2549,48181,33.62744998,-96.67753461,19,0,19,"Grayson, TX",136212
2550,21085,37.46231118,-86.34248968,5,0,5,"Grayson, KY",26427
2551,53027,47.14003705,-123.7820567,12,0,12,"Grays Harbor, WA",75061
2552,48179,35.40081878,-100.8129222,13,0,13,"Gray, TX",21886
2553,21083,36.72292505,-88.65143315,16,0,16,"Graves, KY",37266
2554,26057,43.29265605,-84.60505416,7,0,7,"Gratiot, MI",40711
2555,54023,39.10314817,-79.19440518,1,0,1,"Grant, WV",11568
2556,41023,44.49024544,-119.0068631,1,0,1,"Grant, OR",7199
2557,40053,36.796297,-97.78638765,2,0,2,"Grant, OK",4333
2558,38037,46.35821257,-101.6390013,1,0,1,"Grant, ND",2274
2559,35017,32.73911281,-108.3827845,11,0,11,"Grant, NM",26998
2560,22043,31.59882456,-92.56124347,12,0,12,"Grant, LA",22389
2561,5053,34.29017991,-92.42320562,11,0,11,"Grant, AR",18265
2562,50013,44.7975824,-73.29679772,3,0,3,"Grand Isle, VT",7235
2563,38035,47.92093639,-97.45450447,20,0,20,"Grand Forks, ND",69451
2564,49019,38.98103848,-109.5704487,1,0,1,"Grand, UT",9754
2565,8049,40.10603347,-106.1178042,4,0,4,"Grand, CO",15734
2566,47057,36.27469206,-83.51254721,4,0,4,"Grainger, TN",23320
2567,4009,32.93166885,-109.8882178,2,0,2,"Graham, AZ",38837
2568,33009,43.93779815,-71.82057197,44,0,44,"Grafton, NH",89886
2569,20063,38.91588178,-100.4829321,1,0,1,"Gove, KS",2636
2570,31073,40.51481965,-99.83020279,1,0,1,"Gosper, NE",1990
2571,56015,42.08798185,-104.3534743,3,0,3,"Goshen, WY",13211
2572,16047,42.96927962,-114.8108306,5,0,5,"Gooding, ID",15179
2573,21101,37.79344553,-87.57392021,20,0,20,"Henderson, KY",45210
2574,47077,35.65581134,-88.38600175,2,0,2,"Henderson, TN",28117
2575,48213,32.21128872,-95.85846587,11,0,11,"Henderson, TX",82737
2576,18077,38.78576239,-85.43633383,15,0,15,"Jefferson, IN",32308
2577,55055,43.02054068,-88.77529134,24,0,24,"Jefferson, WI",84769
2578,54037,39.30776166,-77.86014147,54,0,54,"Jefferson, WV",57146
2579,53031,47.75003077,-123.56097040000002,28,0,28,"Jefferson, WA",32221
2580,47089,36.04818632,-83.45148924,16,0,16,"Jefferson, TN",54495
2581,42065,41.12913106,-78.9986361,2,0,2,"Jefferson, PA",43425
2582,41031,44.62806839,-121.17832,1,0,1,"Jefferson, OR",24658
2583,40067,34.11130184,-97.83182974,1,0,1,"Jefferson, OK",6002
2584,39081,40.38614126,-80.76259514,24,0,24,"Jefferson, OH",65325
2585,36045,44.04200959,-75.94653457,47,0,47,"Jefferson, NY",109834
2586,30043,46.14907081,-112.094396,2,0,2,"Jefferson, MT",12221
2587,28063,31.73397872,-91.03764977,4,0,4,"Jefferson, MS",6990
2588,20087,39.2347941,-95.38289232,5,0,5,"Jefferson, KS",19043
2589,19101,41.03192394,-91.94849466,4,0,4,"Jefferson, IA",18295
2590,17081,38.29980057,-88.9240025,9,0,9,"Jefferson, IL",37684
2591,12051,26.55386945,-81.16469006,26,0,26,"Hendry, FL",42022
2592,16051,43.82078483,-112.3131749,4,0,4,"Jefferson, ID",29871
2593,13161,31.80405727,-82.63724870000001,2,0,2,"Jeff Davis, GA",15115
2594,18075,40.43781032,-85.00576229,7,0,7,"Jay, IN",20436
2595,45053,32.43171982,-81.02487495,14,0,14,"Jasper, SC",30073
2596,29097,37.20351921,-94.34050458,27,0,27,"Jasper, MO",121328
2597,28061,32.01922104,-89.11786866,15,0,15,"Jasper, MS",16383
2598,19099,41.68576082,-93.05567785,17,0,17,"Jasper, IA",37185
2599,13159,33.31535543,-83.68844964,10,0,10,"Jasper, GA",14219
2600,48239,28.95472367,-96.57749563,4,0,4,"Jackson, TX",14760
2601,47087,36.36380466,-85.67239905,7,0,7,"Jackson, TN",11786
2602,41029,42.43201126,-122.7289309,47,0,47,"Jackson, OR",220944
2603,40065,34.58781741,-99.41138784,6,0,6,"Jackson, OK",24530
2604,39079,39.01914254,-82.61818559999998,3,0,3,"Jackson, OH",32413
2605,18079,38.99588883,-85.62710784,60,0,60,"Jennings, IN",27735
2606,46073,44.06637798,-98.62965972,3,0,3,"Jerauld, SD",2013
2607,17083,39.08869046,-90.35393073,8,0,8,"Jersey, IL",21773
2608,21113,37.87119786,-84.58252003,29,0,29,"Jessamine, KY",54115
2609,48259,29.94414155,-98.7113588,14,0,14,"Kendall, TX",47431
2610,2122,60.24429722,-151.53888840000005,16,0,16,"Kenai Peninsula, AK",58708
2611,28069,32.75462946,-88.64105766,15,0,15,"Kemper, MS",9742
2612,20093,38.00017981,-101.321681,0,0,0,"Kearny, KS",3838
2613,31099,40.50663314,-98.94877182,3,0,3,"Kearney, NE",6495
2614,48257,32.599141700000004,-96.28734728,33,0,33,"Kaufman, TX",136154
2615,15007,22.03935037,-159.5966786,21,0,21,"Kauai, HI",72293
2616,48255,28.90705334,-97.85960149,3,0,3,"Karnes, TX",15601
2617,49025,37.28507306,-111.8861752,3,0,3,"Kane, UT",7886
2618,27067,45.1526059,-95.00586446,2,0,2,"Kandiyohi, MN",43199
2619,54039,38.33860077,-81.52857054,88,0,88,"Kanawha, WV",178124
2620,42067,40.53358749,-77.39975129999998,47,0,47,"Juniata, PA",24763
2621,2110,58.45031811,-134.200436,21,0,21,"Juneau, AK",31974
2622,48253,32.73997145,-99.87861576,2,0,2,"Jones, TX",20083
2623,28067,31.62257767,-89.16896899999998,42,0,42,"Jones, MS",68098
2624,19105,42.12118609,-91.13139641,11,0,11,"Jones, IA",20681
2625,13169,33.02512137,-83.56019163,15,0,15,"Jones, GA",28735
2626,40069,34.31440473,-96.66011537,2,0,2,"Johnston, OK",11085
2627,47091,36.45523950000001,-81.84886538,2,0,2,"Johnson, TN",17788
2628,31097,40.39257596,-96.26522753,1,0,1,"Johnson, NE",5071
2629,29101,38.74719601,-93.80691168,45,0,45,"Johnson, MO",54062
2630,21115,37.85106355,-82.8264322,1,0,1,"Johnson, KY",22188
2631,17087,37.45939802,-88.88165419,2,0,2,"Johnson, IL",12417
2632,5071,35.56759135,-93.46036368,16,0,16,"Johnson, AR",26578
2633,17085,42.36542373,-90.21094405,11,0,11,"Jo Daviess, IL",21235
2634,48249,27.73103938,-98.0904705,2,0,2,"Jim Wells, TX",40482
2635,20089,39.78470589,-98.21820662,3,0,3,"Jewell, KS",2879
2636,37099,35.28814273,-83.14093385,4,0,4,"Jackson, NC",43938
2637,27063,43.67423373,-95.15398258,1,0,1,"Jackson, MN",9846
2638,22049,32.30251776,-92.55692092,11,0,11,"Jackson, LA",15744
2639,29091,36.77383887,-91.88683935,4,0,4,"Howell, MO",40117
2640,19089,43.35671042,-92.31702714,1,0,1,"Howard, IA",9158
2641,5061,34.09007427,-93.9934871,10,0,10,"Howard, AR",13202
2642,47083,36.28872054,-87.71878828,3,0,3,"Houston, TN",8201
2643,27055,43.67129565,-91.49143057,1,0,1,"Houston, MN",18600
2644,26061,46.89988536,-88.68495385,2,0,2,"Houghton, MI",35684
2645,56017,43.71930657,-108.4423174,1,0,1,"Hot Springs, WY",4413
2646,5059,34.31709259,-92.95396325,8,0,8,"Hot Spring, AR",33771
2647,48223,33.14875072,-95.56351139,4,0,4,"Hopkins, TX",37084
2648,51670,37.29186313,-77.29754684,14,0,14,"Hopewell, VA",22529
2649,41027,45.51872811,-121.65520359999998,4,0,4,"Hood River, OR",23382
2650,39075,40.56163713,-81.92635677,3,0,3,"Holmes, OH",43960
2651,12059,30.86747479,-85.81319222,4,0,4,"Holmes, FL",19617
2652,37093,35.01888303,-79.23651674,22,0,22,"Hoke, NC",55234
2653,39073,39.49537927,-82.47991446,4,0,4,"Hocking, OH",28264
2654,8053,37.82247444,-107.3004345,3,0,3,"Hinsdale, CO",820
2655,48217,31.99045053,-97.13423143,8,0,8,"Hill, TX",36649
2656,30041,48.62879827,-110.1129252,1,0,1,"Hill, MT",16484
2657,51091,38.35799465,-79.56124594,0,0,0,"Highland, VA",2190
2658,39071,39.1839264,-83.60331456,7,0,7,"Highland, OH",43161
2659,35023,31.91383467,-108.7151824,0,0,0,"Hidalgo, NM",4198
2660,47081,35.80609681,-87.47643507,2,0,2,"Hickman, TN",25178
2661,51089,36.68542395,-79.87634026,8,0,8,"Henry, VA",50557
2662,47079,36.33160906,-88.30121797,8,0,8,"Henry, TN",32345
2663,39069,41.3339642,-84.06830637,2,0,2,"Henry, OH",27006
2664,21103,38.44942688,-85.11587507,3,0,3,"Henry, KY",16126
2665,17073,41.3533994,-90.13296166,25,0,25,"Henry, IL",48913
2666,1067,31.51148016,-85.24267944,14,0,14,"Henry, AL",17205
2667,29089,39.1435761,-92.69756691,2,0,2,"Howard, MO",10001
2668,8055,37.68473101,-104.9612585,1,0,1,"Huerfano, CO",6897
2669,21109,37.41866422,-83.99825483,23,0,23,"Jackson, KY",13329
2670,46065,44.39091534,-99.99661148,5,0,5,"Hughes, SD",17526
2671,20085,39.41673394,-95.79356799,1,0,1,"Jackson, KS",13171
2672,19097,42.17178824,-90.57354837,4,0,4,"Jackson, IA",19439
2673,18071,38.90915820000001,-86.03851889,74,0,74,"Jackson, IN",44231
2674,12063,30.7954597,-85.21500423,6,0,6,"Jackson, FL",46414
2675,5067,35.59802983,-91.21494602,1,0,1,"Jackson, AR",16719
2676,48237,33.23377248,-98.17283469,3,0,3,"Jack, TX",8935
2677,5065,36.09604046,-91.90847954,2,0,2,"Izard, AR",13629
2678,28057,34.27993475,-88.3606733,11,0,11,"Itawamba, MS",23390
2679,27061,47.51009045,-93.63092229,2,0,2,"Itasca, MN",45130
2680,51093,36.90579348,-76.70842863,60,0,60,"Isle of Wight, VA",37109
2681,27059,45.56181234,-93.29487636,4,0,4,"Isanti, MN",40596
2682,13155,31.60213036,-83.27501387,12,0,12,"Irwin, GA",9416
2683,17075,40.74717633,-87.82466784,11,0,11,"Iroquois, IL",27114
2684,49021,37.85903620000001,-113.2897381,15,0,15,"Iron, UT",54839
2685,29093,37.55487945,-90.7735296,1,0,1,"Iron, MO",10125
2686,55049,43.00050278,-90.13469017,5,0,5,"Iowa, WI",23678
2687,19095,41.68630265,-92.0643373,7,0,7,"Iowa, IA",16184
2688,6027,36.51112084,-117.41119779999998,17,0,17,"Inyo, CA",18039
2689,5063,35.74242707,-91.57001641,6,0,6,"Independence, AR",37825
2690,16049,45.84721541,-115.4634436,3,0,3,"Idaho, ID",16667
2691,46069,44.54747703,-99.48572582,1,0,1,"Hyde, SD",1301
2692,48233,35.84006574,-101.3546643,3,0,3,"Hutchinson, TX",20938
2693,46067,43.33449012,-97.75536441,2,0,2,"Hutchinson, SD",7291
2694,26063,43.83353985,-83.04078453,7,0,7,"Huron, MI",30981
2695,42061,40.42162652,-77.97673273,12,0,12,"Huntingdon, PA",45144
2696,47085,36.03958805,-87.77992872,4,0,4,"Humphreys, TN",18582
2697,6023,40.69923009,-123.876044,51,0,51,"Humboldt, CA",135558
2698,48505,27.00156391,-99.16987152,3,0,3,"Zapata, TX",14179
